"aa" = (/turf,/area)
"ab" = (/obj/map/noDenseMarker,/turf/village/horizontal_roof_vdalion/top_left,/area)
"ac" = (/obj/map/noDenseMarker,/turf/village/horizontal_roof_vdalion/top_fill,/area)
"ad" = (/obj/map/noDenseMarker,/turf/village/horizontal_roof_vdalion/top_right,/area)
"ae" = (/obj/map/noDenseMarker,/turf/village/horizontal_roof_vdalion/left,/area)
"af" = (/turf/village/horizontal_roof_vdalion/fill,/area)
"ag" = (/obj/map/noDenseMarker,/turf/village/horizontal_roof_vdalion/right,/area)
"ah" = (/SmallPreview/End,/MapLimit,/turf,/area)
"ai" = (/turf/village/wall_vdalion/bottom_left,/turf/village/horizontal_roof_vdalion/bottom_fill,/area)
"aj" = (/turf/village/wall_vdalion/bottom,/turf/village/horizontal_roof_vdalion/bottom_fill,/area)
"ak" = (/turf/village/wall_vdalion/bottom_right,/turf/village/horizontal_roof_vdalion/bottom_fill,/area)
"al" = (/turf/village/roof_vdalion/left_3,/obj/map/noDenseMarker,/turf/village/horizontal_roof_vdalion/bottom_left,/area)
"am" = (/turf/village/roof_vdalion/right_3,/obj/map/noDenseMarker,/turf/village/horizontal_roof_vdalion/bottom_right,/area)
"an" = (/turf/village/roof_vdalion/left_2,/turf/village/horizontal_roof_vdalion/top_fill,/area)
"ao" = (/turf/village/wall_vdalion/bottom_left,/area)
"ap" = (/turf/village/roof_vdalion/left_3,/obj/map/noDenseMarker,/turf/village/horizontal_roof_vdalion/top_fill,/area)
"aq" = (/turf/village/wall_vdalion/bottom_right,/area)
"ar" = (/turf/village/roof_vdalion/right_2,/turf/village/horizontal_roof_vdalion/top_fill,/area)
"as" = (/turf/village/wall_vdalion/bottom,/obj/map/shop_int/window/dark,/turf/village/roof_vdalion/center_3{layer = 7},/area)
"at" = (/turf/village/wall_vdalion/bottom_left,/turf/village/roof_vdalion/left_3{layer = 7},/area)
"au" = (/turf/village/roof_vdalion/center_2,/area)
"av" = (/turf/village/wall_vdalion/bottom_right,/turf/village/roof_vdalion/right_3{layer = 7},/area)
"aw" = (/turf/village/horizontal_roof_vdalion/fill,/turf/village/roof_vdalion/left_3{layer = 7},/area)
"ax" = (/turf/village/roof_vdalion/left_2,/area)
"ay" = (/turf/village/wall_vdalion/bottom,/turf/village/roof_vdalion/center_1,/area)
"az" = (/turf/village/roof_vdalion/right_2,/area)
"aA" = (/turf/village/horizontal_roof_vdalion/fill,/turf/village/roof_vdalion/right_3{layer = 7},/area)
"aB" = (/turf/academy/rail/top_left,/area)
"aC" = (/turf/academy/rail/top,/turf/village/horizontal_roof_vdalion/left,/area)
"aD" = (/turf/village/wall_vdalion/bottom,/turf/village/roof_vdalion/left_1,/area)
"aE" = (/turf/village/wall_vdalion/bottom,/turf/village/roof_vdalion/left_4,/turf/village/roof_vdalion/right_4,/area)
"aF" = (/turf/village/wall_vdalion/bottom,/turf/village/roof_vdalion/right_1,/area)
"aG" = (/turf/academy/rail/top,/turf/village/horizontal_roof_vdalion/right,/area)
"aH" = (/turf/academy/rail/top_right,/area)
"aI" = (/turf/academy/rail/top,/area)
"aJ" = (/turf/academy/rail/left,/area)
"aK" = (/turf/academy/floor,/turf/village/horizontal_roof_vdalion/bottom_left,/area)
"aL" = (/turf/village/wall_vdalion/bottom,/turf/village/roof_vdalion/left_4,/area)
"aM" = (/turf/village/wall_vdalion/bottom,/area)
"aN" = (/turf/village/wall_vdalion/bottom,/turf/village/roof_vdalion/right_4,/area)
"aO" = (/turf/academy/floor,/turf/village/horizontal_roof_vdalion/bottom_right,/area)
"aP" = (/turf/academy/rail/right,/area)
"aQ" = (/turf/academy/floor,/area)
"aR" = (/obj/map/shop_int/window/dark,/turf/village/wall_vdalion/bottom,/area)
"aS" = (/turf/village/wall_vdalion/bottom_left,/turf/village/roof_vdalion/left_1,/area)
"aT" = (/turf/village/wall_vdalion/bottom_right,/turf/village/roof_vdalion/right_1,/area)
"aU" = (/turf/village/wall_vdalion/bottom,/turf/village/vdalion_extra/windowbig_5,/turf/village/vdalion_extra/snow_2,/area)
"aV" = (/turf/academy/rail/bottom_left,/area)
"aW" = (/turf/academy/rail/bottom,/area)
"aX" = (/turf/academy/rail/bottom_right,/area)
"aY" = (/turf/village/wall_vdalion/top_left,/turf/city/wall/gap,/area)
"aZ" = (/turf/village/wall_vdalion/top_middle,/area)
"ba" = (/turf/village/wall_vdalion/top_right,/turf/city/wall/gap/right,/area)
"bb" = (/turf/village/wall_vdalion/foundation_left,/area)
"bc" = (/turf/village/wall_vdalion/foundation_middle,/area)
"bd" = (/obj/map/castle/gate/close,/turf/village/wall_vdalion/foundation_middle,/area)
"be" = (/Building/Warper/Exterior,/turf/village/wall_vdalion/foundation_middle,/area)
"bf" = (/turf/village/wall_vdalion/foundation_right,/area)
"bg" = (/turf/village/wall_vdalion/foundation_left,/turf/village/vdalion_extra/snow_1,/area)
"bh" = (/turf/village/wall_vdalion/foundation_middle,/turf/village/vdalion_extra/snow_1,/area)
"bi" = (/turf/village/wall_vdalion/foundation_right,/turf/village/vdalion_extra/snow_1,/area)
"bj" = (/turf/academy/floor,/turf/castle_int/stairs/top_left,/turf/castle_int/ledge/left_1,/area)
"bk" = (/turf/academy/floor,/turf/castle_int/stairs/top,/area)
"bl" = (/turf/academy/floor,/turf/castle_int/stairs/top_right,/turf/castle_int/ledge/right_1,/area)
"bm" = (/turf/village/wall_vdalion/bottom_left,/turf/jianghu_house/shadow{density = 1},/turf/village/vdalion_extra/snow_1,/area)
"bn" = (/turf/castle_int/stairs/left,/area)
"bo" = (/turf/castle_int/stairs/middle,/area)
"bp" = (/turf/castle_int/stairs/right,/area)
"bq" = (/turf/village/wall_vdalion/bottom,/turf/village/vdalion_extra/snow_1,/area)
"br" = (/turf/village/wall_vdalion/bottom_right,/turf/jianghu_house/shadow{density = 1},/turf/village/vdalion_extra/snow_1,/area)
"bs" = (/turf/village/road_brown/left,/turf/castle_int/stairs/bottom_left,/area)
"bt" = (/turf/castle_int/stairs/bottom,/area)
"bu" = (/turf/castle_int/stairs/bottom_right,/area)
"bv" = (/BuildingDetails{building_category = "Vdalion"; building_cost = 50000; building_desc = "A Church building."; building_guild = "Vdalion"; building_interior = 0; building_name = "VS-Church"},/turf/village/wall_vdalion/bottom,/area)
"bw" = (/turf/village/roof_vdalion/right_3,/obj/map/noDenseMarker,/turf/village/horizontal_roof_vdalion/top_fill,/area)
"bx" = (/SmallPreview/Start,/turf,/area)
"by" = (/turf/village/wall_vdalion/bottom,/turf/village/horizontal_roof_vdalion/bottom_fill,/turf/village/roof_vdalion/left_5{layer = 7},/area)
"bz" = (/turf/village/wall_vdalion/bottom,/turf/village/horizontal_roof_vdalion/bottom_fill,/turf/village/roof_vdalion/right_5{layer = 7},/area)
"bA" = (/turf/village/wall_vdalion/bottom,/turf/village/roof_vdalion/left_6{layer = 3},/area)
"bB" = (/turf/village/wall_vdalion/bottom,/turf/village/roof_vdalion/right_6{layer = 7},/area)
"bC" = (/turf/village/wall_vdalion/bottom,/turf/village/roof_vdalion/left_7,/area)
"bD" = (/turf/village/wall_vdalion/bottom_left,/turf/village/roof_vdalion/left_4,/area)
"bE" = (/turf/village/wall_vdalion/bottom_right,/turf/village/roof_vdalion/right_4,/area)
"bF" = (/turf/village/wall_vdalion/bottom,/turf/village/roof_vdalion/right_7{layer = 7},/area)

(1,1,1) = {"
aaaaaaaaaaaaaaaaaaabacacacadaaaaaaaaaaaaaaaaah
aaaaaaaaaaaaaaaaaaaeafafafagaaaaaaaaaaaaaaaaaa
aaaaaaaaaaaaaaaaaaaeafafafagaaaaaaaaaaaaaaaaaa
aaaaaaaaaaaaaaaaaaalaiajakamaaaaaaaaaaaaaaaaaa
aaaaaaaaabacacacapanaoasaqarbwacacacadaaaaaaaa
aaaaaaaaaeafafafafafatauavafafafafafagaaaaaaaa
aaaaaaaaaeafafafafawaxayazaAafafafafagaaaaaaaa
aaaaaaaBaCafafafawaxaDaEaFazaAafafafaGaHaaaaaa
aaaaaaaJaKaiajbyaxaDaLaMaNaFazbzajakaOaPaaaaaa
aaaBaIaJaQaoaRbAaSaLaMaMaMaNaTbBaRaqaQaPaIaHaa
aaaJaQaJaQaoaUbCbDaRaMaMaMaRbEbFaUaqaQaPaQaPaa
aaaJaQaJaQaQaQaQaoaUaMaMaMaUaqaQaQaQaQaPaQaPaa
aaaJaQaVaWaWaWaWaWaWaWaWaWaWaWaWaWaWaWaXaQaPaa
aaaVaWaoaMaMaMaMaqaMaMbvaMaMaoaMaMaMaMaqaWaXaa
aaaoaMaoaMaMaMaMaqaYaZaZaZbaaoaMaMaMaMaqaMaqaa
aaaoaMaoaRaMaMaRaqbbbdbebcbfaoaRaMaMaRaqaMaqaa
aabgbhaoaUaMaMaUaqaQaQaQaQaQaoaUaMaMaUaqbhbiaa
aaaaaabgbhbhaJaQaQaQaQaQaQaQaQaQaPbhbhbiaaaaaa
aaaaaaaaaaaaaVbjbkblaWaWaWbjbkblaXaaaaaaaaaaaa
aaaaaaaaaaaabmbnbobpbmbqbrbnbobpbraaaaaaaaaaaa
bxaaaaaaaaaaaabsbtbuaaaaaabsbtbuaaaaaaaaaaaaaa
"}
