"aa" = (/turf,/area)
"ab" = (/obj/map/noDenseMarker,/turf/village/roof_vdalion/center_3,/area)
"ac" = (/SmallPreview/End,/MapLimit,/turf,/area)
"ad" = (/obj/map/noDenseMarker,/turf/village/roof_vdalion/left_3,/area)
"ae" = (/obj/map/noDenseMarker,/turf/village/roof_vdalion/center_2,/area)
"af" = (/obj/map/noDenseMarker,/turf/village/roof_vdalion/right_3,/area)
"ag" = (/turf/village/roof_vdalion/left_2,/area)
"ah" = (/turf/village/roof_vdalion/center_2,/area)
"ai" = (/turf/village/roof_vdalion/right_2,/area)
"aj" = (/obj/map/noDenseMarker,/turf/village/horizontal_roof_vdalion/top_left,/area)
"ak" = (/obj/map/noDenseMarker,/turf/village/horizontal_roof_vdalion/top_fill,/area)
"al" = (/turf/village/roof_vdalion/left_3,/obj/map/noDenseMarker,/turf/village/horizontal_roof_vdalion/top_fill,/area)
"am" = (/turf/village/roof_vdalion/left_2,/turf/village/horizontal_roof_vdalion/top_fill,/area)
"an" = (/turf/village/roof_vdalion/center_2,/turf/village/horizontal_roof_vdalion/top_right,/turf/village/roof_vdalion/center_3{layer = 7},/turf/village/horizontal_roof_vdalion/top_middle,/area)
"ao" = (/turf/village/roof_vdalion/right_2,/turf/village/horizontal_roof_vdalion/top_fill,/area)
"ap" = (/turf/village/roof_vdalion/right_3,/obj/map/noDenseMarker,/turf/village/horizontal_roof_vdalion/top_fill,/area)
"aq" = (/obj/map/noDenseMarker,/turf/village/horizontal_roof_vdalion/top_right,/area)
"ar" = (/obj/map/noDenseMarker,/turf/village/horizontal_roof_vdalion/left,/area)
"as" = (/turf/village/horizontal_roof_vdalion/fill,/area)
"at" = (/turf/village/horizontal_roof_vdalion/fill,/turf/village/roof_vdalion/left_3{layer = 7},/area)
"au" = (/turf/village/horizontal_roof_vdalion/fill,/turf/village/roof_vdalion/right_3{layer = 7},/area)
"av" = (/obj/map/noDenseMarker,/turf/village/horizontal_roof_vdalion/right,/area)
"aw" = (/obj/map/noDenseMarker,/turf/village/roof_vdalion/left_5,/area)
"ax" = (/turf/village/roof_vdalion/center_2,/turf/village/horizontal_roof_vdalion/top_left,/turf/village/roof_vdalion/center_3{layer = 7},/area)
"ay" = (/turf/village/roof_vdalion/right_5,/obj/map/noDenseMarker,/turf/village/horizontal_roof_vdalion/top_fill,/area)
"az" = (/turf/village/wall_vdalion/bottom,/turf/village/roof_vdalion/center_1,/area)
"aA" = (/turf/village/roof_vdalion/left_5,/obj/map/noDenseMarker,/turf/village/horizontal_roof_vdalion/top_fill,/area)
"aB" = (/turf/village/roof_vdalion/center_2,/turf/village/horizontal_roof_vdalion/top_right,/turf/village/roof_vdalion/center_3{layer = 7},/area)
"aC" = (/obj/map/noDenseMarker,/turf/village/roof_vdalion/right_5,/area)
"aD" = (/obj/map/noDenseMarker,/turf/village/roof_vdalion/left_6,/area)
"aE" = (/turf/academy/rail/top,/turf/village/horizontal_roof_vdalion/right,/area)
"aF" = (/turf/academy/rail/top,/turf/village/horizontal_roof_vdalion/left,/area)
"aG" = (/turf/village/wall_vdalion/bottom,/turf/village/roof_vdalion/left_1,/area)
"aH" = (/turf/village/wall_vdalion/bottom,/turf/village/roof_vdalion/left_4,/turf/village/roof_vdalion/right_4,/area)
"aI" = (/turf/village/wall_vdalion/bottom,/turf/village/roof_vdalion/right_1,/area)
"aJ" = (/obj/map/noDenseMarker,/turf/village/roof_vdalion/right_6,/area)
"aK" = (/turf/academy/floor,/obj/generic_shadow/white{alpha = 50; color = "black"; icon_state = "full"},/turf/village/horizontal_roof_vdalion/right,/area)
"aL" = (/turf/academy/floor,/obj/generic_shadow/white{alpha = 50; color = "black"; icon_state = "full"},/turf/village/horizontal_roof_vdalion/left,/area)
"aM" = (/turf/village/wall_vdalion/bottom,/turf/village/roof_vdalion/left_4,/area)
"aN" = (/turf/village/wall_vdalion/bottom,/area)
"aO" = (/turf/village/wall_vdalion/bottom,/turf/village/roof_vdalion/right_4,/area)
"aP" = (/turf/village/wall_vdalion/bottom_right,/turf/village/horizontal_roof_vdalion/bottom_fill,/obj/generic_shadow/white{alpha = 50; color = "black"; icon_state = "full"},/turf/village/roof_vdalion/right_5{layer = 7},/area)
"aQ" = (/turf/academy/floor,/obj/generic_shadow/white{alpha = 50; color = "black"; icon_state = "full"},/turf/village/horizontal_roof_vdalion/bottom_right,/area)
"aR" = (/turf/academy/floor,/obj/generic_shadow/white{alpha = 50; color = "black"; icon_state = "tl_corner"},/turf/village/horizontal_roof_vdalion/bottom_left,/area)
"aS" = (/turf/village/wall_vdalion/bottom_left,/turf/village/horizontal_roof_vdalion/bottom_fill,/turf/village/roof_vdalion/left_5{layer = 7},/area)
"aT" = (/turf/village/wall_vdalion/bottom_left,/turf/village/roof_vdalion/left_1,/area)
"aU" = (/turf/village/wall_vdalion/bottom_right,/obj/generic_shadow/white{alpha = 50; color = "black"; icon_state = "full"},/turf/village/roof_vdalion/right_6{layer = 7},/area)
"aV" = (/obj/generic_shadow/white{alpha = 50; color = "black"; icon_state = "tl_corner"},/turf/academy/floor,/area)
"aW" = (/turf/academy/floor,/area)
"aX" = (/turf/village/wall_vdalion/bottom_left,/turf/village/roof_vdalion/left_6{layer = 3},/area)
"aY" = (/obj/map/shop_int/window/dark,/turf/village/wall_vdalion/bottom,/area)
"aZ" = (/BuildingDetails{building_category = "Vdalion"; building_cost = "150000"; building_desc = "A large fort."; building_guild = "Vdalion"; building_interior = 0; building_name = "VS-Fort Snow"; building_settlement_only = 1},/turf/village/wall_vdalion/bottom,/area)
"ba" = (/turf/village/wall_vdalion/bottom_right,/turf/village/roof_vdalion/right_1,/area)
"bb" = (/turf/academy/floor,/obj/generic_shadow/white{alpha = 50; color = "black"; icon_state = "tl_corner"},/obj/generic_shadow/white{alpha = 75; color = "black"; icon_state = "top"},/turf/village/roof_vdalion/right_6{layer = 7},/area)
"bc" = (/turf/academy/floor,/obj/generic_shadow/white{alpha = 75; color = "black"; icon_state = "top"},/turf/village/roof_vdalion/left_7,/area)
"bd" = (/turf/village/wall_vdalion/bottom_left,/turf/village/roof_vdalion/left_4,/area)
"be" = (/turf/village/wall_vdalion/bottom_right,/turf/village/roof_vdalion/right_4,/area)
"bf" = (/turf/academy/floor,/obj/generic_shadow/white{alpha = 50; color = "black"; icon_state = "tl_corner"},/obj/generic_shadow/white{alpha = 75; color = "black"; icon_state = "top"},/turf/village/roof_vdalion/right_7{layer = 7},/area)
"bg" = (/turf/academy/floor,/obj/generic_shadow/white{alpha = 75; color = "black"; icon_state = "top"},/turf/village/roof_vdalion/left_6{layer = 3},/area)
"bh" = (/obj/map/noDenseMarker,/turf/village/roof_vdalion/left_7,/area)
"bi" = (/turf/academy/rail/bottom,/turf/village/roof_vdalion/right_7{layer = 7},/area)
"bj" = (/turf/academy/rail/bottom,/area)
"bk" = (/turf/academy/rail/bottom_right,/area)
"bl" = (/obj/generic_shadow/white{alpha = 50; color = "black"; icon_state = "bl_corner"},/turf/village/wall_vdalion/bottom,/area)
"bm" = (/turf/academy/rail/bottom_left,/area)
"bn" = (/turf/academy/rail/bottom,/turf/village/roof_vdalion/left_7,/area)
"bo" = (/obj/map/noDenseMarker,/turf/village/roof_vdalion/right_7,/area)
"bp" = (/turf/village/wall_vdalion/bottom_left,/area)
"bq" = (/turf/village/wall_vdalion/bottom_right,/area)
"br" = (/turf/village/wall_vdalion/bottom,/obj/generic_shadow/white{alpha = 50; color = "black"; icon_state = "full"},/turf/jianghu_house/shadow{density = 1},/area)
"bs" = (/turf/village/wall_vdalion/bottom,/turf/jianghu_house/shadow{density = 1},/area)
"bt" = (/turf/village/wall_vdalion/bottom_right,/turf/jianghu_house/shadow{density = 1},/area)
"bu" = (/obj/generic_shadow/white{alpha = 50; color = "black"; icon_state = "full"},/turf/village/wall_vdalion/foundation_middle,/area)
"bv" = (/obj/map/castle/gate/close,/obj/generic_shadow/white{alpha = 50; color = "black"; icon_state = "full"},/turf/village/wall_vdalion/foundation_middle,/area)
"bw" = (/Building/Warper/Exterior,/turf/village/wall_vdalion/foundation_middle,/area)
"bx" = (/turf/village/wall_vdalion/foundation_middle,/area)
"by" = (/turf/village/wall_vdalion/bottom_left,/turf/jianghu_house/shadow{density = 1},/area)
"bz" = (/obj/generic_shadow/white{alpha = 50; color = "black"; icon_state = "full"},/turf/village/wall_vdalion/bottom,/area)
"bA" = (/obj/generic_shadow/white{alpha = 50; color = "black"; icon_state = "tl_corner"},/obj/generic_shadow/white{alpha = 75; color = "black"; icon_state = "top"},/turf/academy/floor,/area)
"bB" = (/obj/generic_shadow/white{alpha = 75; color = "black"; icon_state = "top"},/turf/academy/floor,/area)
"bC" = (/turf/village/wall_vdalion/foundation_middle,/obj/generic_shadow/white{alpha = 50; color = "black"; icon_state = "full"},/turf/village/vdalion_extra/snow_1,/area)
"bD" = (/turf/village/wall_vdalion/foundation_middle,/turf/village/vdalion_extra/snow_1,/area)
"bE" = (/obj/generic_shadow/white{alpha = 75; color = "black"; icon_state = "top"},/turf/academy/rail/left,/area)
"bF" = (/obj/generic_shadow/white{alpha = 75; color = "black"; icon_state = "top"},/obj/map/village/statue/soldier/right{pixel_y = 10},/turf/academy/floor,/area)
"bG" = (/obj/generic_shadow/white{alpha = 75; color = "black"; icon_state = "top"},/obj/map/village/statue/soldier/left{pixel_y = 10},/turf/academy/floor,/area)
"bH" = (/obj/generic_shadow/white{alpha = 75; color = "black"; icon_state = "top"},/turf/academy/rail/right,/area)
"bI" = (/turf/village/wall_vdalion/foundation_middle,/obj/generic_shadow/white{alpha = 50; color = "black"; icon_state = "bl_corner"},/turf/village/vdalion_extra/snow_1,/area)
"bJ" = (/SmallPreview/Start,/turf,/area)
"bK" = (/turf/village/wall_vdalion/foundation_left,/turf/village/vdalion_extra/snow_1,/area)
"bL" = (/turf/village/wall_vdalion/foundation_right,/turf/village/vdalion_extra/snow_1,/Region{desc = "Osrona's merchant district, Caelfall has a high number of shops and large homes for those more well off than the majority of the population. Within the middle is a large park with a small body of water within it's center. The jail, as well as the City Watch's headquarters is also known to be found here."; name = "Caelfall"})
"bM" = (/obj/generic_shadow/white{alpha = 50; color = "black"; icon_state = "tl_corner"},/obj/generic_shadow/white{alpha = 75; color = "black"; icon_state = "top"},/turf,/area)
"bN" = (/obj/generic_shadow/white{alpha = 75; color = "black"; icon_state = "top"},/turf,/area)
"bO" = (/turf/academy/rail/left,/area)
"bP" = (/turf/academy/rail/right,/area)
"bQ" = (/obj/generic_shadow/white{alpha = 50; color = "black"; icon_state = "full"},/obj/generic_shadow/white{alpha = 75; color = "black"; icon_state = "top"},/turf,/area)
"bR" = (/turf/void,/area)
"bS" = (/turf/academy/fence/side/left,/area)
"bT" = (/turf/academy/floor,/turf/castle_int/stairs/top_left,/turf/castle_int/ledge/left_1,/area)
"bU" = (/turf/academy/floor,/turf/castle_int/stairs/top,/area)
"bV" = (/turf/academy/floor,/turf/castle_int/stairs/top_right,/turf/castle_int/ledge/right_1,/area)
"bW" = (/obj/generic_shadow/white{alpha = 50; color = "black"; icon_state = "full"},/turf,/area)
"bX" = (/turf/academy/fence/side/right,/area)
"bY" = (/turf/village/wall_vdalion/bottom_left,/turf/jianghu_house/shadow{density = 1},/turf/village/vdalion_extra/snow_1,/area)
"bZ" = (/turf/village/wall_vdalion/bottom,/turf/jianghu_house/shadow{density = 1},/turf/village/vdalion_extra/snow_1,/area)
"ca" = (/turf/castle_int/stairs/left,/area)
"cb" = (/turf/castle_int/stairs/middle,/area)
"cc" = (/turf/castle_int/stairs/right,/area)
"cd" = (/turf/village/wall_vdalion/foundation_right,/turf/village/vdalion_extra/snow_1,/area)
"ce" = (/turf/village/wall_vdalion/bottom_right,/turf/jianghu_house/shadow{density = 1},/turf/village/vdalion_extra/snow_1,/area)
"cf" = (/obj/generic_shadow/white{alpha = 50; color = "black"; icon_state = "tl_corner"},/turf,/area)
"cg" = (/turf/village/road_brown/left,/turf/castle_int/stairs/bottom_left,/area)
"ch" = (/turf/castle_int/stairs/bottom,/area)
"ci" = (/turf/castle_int/stairs/bottom_right,/area)
"cj" = (/turf/academy/fence/horizontal/bottom/left,/area)
"ck" = (/turf/academy/fence/horizontal/bottom/middle,/area)
"cl" = (/turf/academy/fence/post/left,/area)
"cm" = (/turf/academy/fence/post/right,/area)
"cn" = (/turf/academy/fence/horizontal/bottom/right,/area)
"co" = (/turf/village/wall_vdalion/bottom,/turf/jianghu_house/shadow{density = 1},/obj/generic_shadow/white{alpha = 50; color = "black"; icon_state = "full"},/turf/village/vdalion_extra/snow_1,/area)

(1,1,1) = {"
aaaaaaaaaaaaaaaaaaaaaaaaaaaaabaaaaaaaaaaaaaaaaaaaaaaaaaaac
aaaaaaaaaaaaaaaaaaaaaaaaaaadaeafaaaaaaaaaaaaaaaaaaaaaaaaaa
aaaaaaabaaaaaaaaaaaaaaaaadagahaiafaaaaaaaaaaaaaaaaabaaaaaa
aaaaadaeafaaaaaaajakakalamamanaoaoapakakaqaaaaaaadaeafaaaa
aaadagahaiafaaaaarasasasasatahauasasasasavaaaaadagahaiafaa
awagagaxaoaoayaqarasasasatagazaiauasasasavajaAamamaBaiaiaC
aDagagahauasasaEaFasasatagaGaHaIaiauasasaEaFasasatahaiaiaJ
aDagagahaiauasaKaLasatagaGaMaNaOaIaiauasaKaLasatagahaiaiaJ
aDagagazaiaiaPaQaRaSagaTaMaNaNaNaOaIaiaPaQaRaSagagazaiaiaJ
aDagaGaHaIaiaUaVaWaXaTaMaYaNaZaNaYaObaaUaVaWaXagaGaHaIaiaJ
aDaTaMaYaObabbaWaWbcbdaNaNaNaNaNaNaNbebfaWaWbgaTaMaYaObaaJ
bhbdaNaNaNbebibjbjbjbjbkblaNaNaNaNbmbjbjbjbjbnbdaNaNaNbebo
aabpaNaNaNbqbrbsbsbsbsbtbubvbwbxbxbybsbsbsbsbsbpaNaNaNbqaa
aabpaNaYaNbqbzaYaNaNaNbqbAbBbBbBbBbpaNaNaNaYaNbpaNaYaNbqaa
aabpaNaNaNbqbCbDbDbEbFbBaWaWaWaWaWbBbGbHbIbDbDbpaNaNaNbqaa
bJbKbDbDbDcdbMbNbNbOaWaWaWaWaWaWaWaWaWbPbQbNbNbKbDbDbDbLaa
bRbRbSaaaaaaaaaaaabmbjbTbUbUbUbUbUbVbjbkbWaaaaaaaaaabXbRbR
bRbRbSaaaaaaaaaaaabYbZcacbcbcbcbcbcccocecfaaaaaaaaaabXbRbR
bRbRbSaaaaaaaaaaaaaaaacgchchchchchcicfaaaaaaaaaaaaaabXbRbR
bRbRbSaaaaaaaaaaaaaaaaaaaaaaaaaaaaaaaaaaaaaaaaaaaaaabXbRbR
bRbRbSaaaaaaaaaaaaaaaaaaaaaaaaaaaaaaaaaaaaaaaaaaaaaabXbRbR
bRbRcjckckckckckckclaaaaaaaaaaaaaaaaaacmckckckckckckcnbRbR
bRbRbRbRbRbRbRbRbRbRbRbRbRbRbRbRbRbRbRbRbRbRbRbRbRbRbRbRbR
"}
