"aa" = (/turf/void,/area)
"ab" = (/turf,/area)
"ac" = (/obj/map/noDenseMarker,/turf/village/roof_vdalion/center_3,/area)
"ad" = (/obj/map/noDenseMarker,/turf/village/roof_vdalion/left_3,/area)
"ae" = (/obj/map/noDenseMarker,/turf/village/roof_vdalion/center_2,/area)
"af" = (/obj/map/noDenseMarker,/turf/village/roof_vdalion/right_3,/area)
"ag" = (/turf/village/roof_vdalion/left_2,/area)
"ah" = (/turf/village/roof_vdalion/center_2,/area)
"ai" = (/turf/village/roof_vdalion/right_2,/area)
"aj" = (/obj/map/noDenseMarker,/turf/village/roof_vdalion/left_5,/area)
"ak" = (/turf/village/wall_vdalion/bottom,/turf/village/roof_vdalion/center_1,/area)
"al" = (/obj/map/noDenseMarker,/turf/village/roof_vdalion/right_2,/area)
"am" = (/obj/map/noDenseMarker,/turf/village/roof_vdalion/left_6,/area)
"an" = (/turf/village/wall_vdalion/bottom,/turf/village/roof_vdalion/left_1,/area)
"ao" = (/turf/village/wall_vdalion/bottom,/turf/village/roof_vdalion/right_4,/area)
"ap" = (/turf/village/wall_vdalion/bottom,/turf/village/roof_vdalion/right_1,/area)
"aq" = (/obj/map/noDenseMarker,/turf/village/horizontal_roof_vdalion/top_fill,/area)
"ar" = (/obj/map/noDenseMarker,/turf/village/horizontal_roof_vdalion/top_right,/area)
"as" = (/turf/inn/rail/middle,/turf/inn/rail/left,/area)
"at" = (/turf/inn/rail/middle,/area)
"au" = (/turf/inn/rail/middle,/turf/village/roof_vdalion/left_6,/area)
"av" = (/turf/village/wall_vdalion/bottom,/turf/village/roof_vdalion/left_4,/area)
"aw" = (/turf/village/wall_vdalion/bottom,/turf/village/vdalion_extra/window_2,/area)
"ax" = (/turf/village/horizontal_roof_vdalion/fill,/area)
"ay" = (/obj/map/noDenseMarker,/turf/village/horizontal_roof_vdalion/right,/area)
"az" = (/turf/inn/floor,/turf/inn/rail/left,/Region{desc = "Osrona's merchant district, Caelfall has a high number of shops and large homes for those more well off than the majority of the population. Within the middle is a large park with a small body of water within it's center. The jail, as well as the City Watch's headquarters is also known to be found here."; name = "Caelfall"})
"aA" = (/turf/inn/floor,/Region{desc = "Osrona's merchant district, Caelfall has a high number of shops and large homes for those more well off than the majority of the population. Within the middle is a large park with a small body of water within it's center. The jail, as well as the City Watch's headquarters is also known to be found here."; name = "Caelfall"})
"aB" = (/SmallPreview/End,/turf,/area)
"aC" = (/turf/village/wall_vdalion/bottom,/area)
"aD" = (/turf/village/wall_vdalion/bottom,/turf/village/vdalion_extra/windowbig_5,/area)
"aE" = (/MapLimit,/turf/void,/area)
"aF" = (/turf/village/wall_vdalion/bottom_left,/turf/village/roof_vdalion/left_4,/area)
"aG" = (/turf/village/wall_vdalion/bottom,/turf/village/horizontal_roof_vdalion/top_left,/area)
"aH" = (/turf/village/wall_vdalion/bottom,/turf/village/horizontal_roof_vdalion/top_fill,/area)
"aI" = (/turf/village/wall_vdalion/bottom_right,/turf/village/horizontal_roof_vdalion/top_fill,/turf/village/roof_vdalion/right_4,/area)
"aJ" = (/turf/village/wall_vdalion/bottom_left,/area)
"aK" = (/turf/village/wall_vdalion/bottom,/turf/village/horizontal_roof_vdalion/left,/area)
"aL" = (/turf/village/wall_vdalion/foundation_left,/area)
"aM" = (/turf/village/wall_vdalion/foundation_middle,/turf/village/horizontal_roof_vdalion/bottom_left,/area)
"aN" = (/turf/village/wall_vdalion/bottom_left,/turf/village/horizontal_roof_vdalion/bottom_fill,/area)
"aO" = (/turf/village/wall_vdalion/bottom,/turf/village/vdalion_extra/windowbig_4,/turf/village/horizontal_roof_vdalion/bottom_fill,/area)
"aP" = (/turf/village/wall_vdalion/bottom,/turf/village/horizontal_roof_vdalion/bottom_fill,/area)
"aQ" = (/turf/inn/floor,/obj/map/noDenseMarker,/turf/village/roof_vdalion/left_6,/Region{desc = "Osrona's merchant district, Caelfall has a high number of shops and large homes for those more well off than the majority of the population. Within the middle is a large park with a small body of water within it's center. The jail, as well as the City Watch's headquarters is also known to be found here."; name = "Caelfall"})
"aR" = (/turf/village/wall_vdalion/bottom_right,/turf/village/horizontal_roof_vdalion/bottom_fill,/area)
"aS" = (/obj/map/noDenseMarker,/turf/village/horizontal_roof_vdalion/bottom_right,/area)
"aT" = (/turf/inn/floor,/turf/inn/rail/middle,/Region{desc = "Osrona's merchant district, Caelfall has a high number of shops and large homes for those more well off than the majority of the population. Within the middle is a large park with a small body of water within it's center. The jail, as well as the City Watch's headquarters is also known to be found here."; name = "Caelfall"})
"aU" = (/turf/inn/floor,/turf/shop_int/stairs/top_left,/Region{desc = "Osrona's merchant district, Caelfall has a high number of shops and large homes for those more well off than the majority of the population. Within the middle is a large park with a small body of water within it's center. The jail, as well as the City Watch's headquarters is also known to be found here."; name = "Caelfall"})
"aV" = (/turf/inn/floor,/turf/shop_int/stairs/top,/Region{desc = "Osrona's merchant district, Caelfall has a high number of shops and large homes for those more well off than the majority of the population. Within the middle is a large park with a small body of water within it's center. The jail, as well as the City Watch's headquarters is also known to be found here."; name = "Caelfall"})
"aW" = (/turf/inn/floor,/turf/shop_int/stairs/top_right,/Region{desc = "Osrona's merchant district, Caelfall has a high number of shops and large homes for those more well off than the majority of the population. Within the middle is a large park with a small body of water within it's center. The jail, as well as the City Watch's headquarters is also known to be found here."; name = "Caelfall"})
"aX" = (/turf/village/wall_vdalion/bottom,/turf/village/vdalion_extra/windowbig_3,/area)
"aY" = (/turf/village/wall_vdalion/bottom,/turf/village/vdalion_extra/door_top,/area)
"aZ" = (/turf/village/wall_vdalion/bottom_right,/area)
"ba" = (/turf/shop_int/stairs/left,/Region{desc = "Osrona's merchant district, Caelfall has a high number of shops and large homes for those more well off than the majority of the population. Within the middle is a large park with a small body of water within it's center. The jail, as well as the City Watch's headquarters is also known to be found here."; name = "Caelfall"})
"bb" = (/turf/shop_int/stairs/middle,/Region{desc = "Osrona's merchant district, Caelfall has a high number of shops and large homes for those more well off than the majority of the population. Within the middle is a large park with a small body of water within it's center. The jail, as well as the City Watch's headquarters is also known to be found here."; name = "Caelfall"})
"bc" = (/turf/shop_int/stairs/right,/Region{desc = "Osrona's merchant district, Caelfall has a high number of shops and large homes for those more well off than the majority of the population. Within the middle is a large park with a small body of water within it's center. The jail, as well as the City Watch's headquarters is also known to be found here."; name = "Caelfall"})
"bd" = (/turf/inn/floor,/obj/map/noDenseMarker,/turf/village/roof_vdalion/left_7,/Region{desc = "Osrona's merchant district, Caelfall has a high number of shops and large homes for those more well off than the majority of the population. Within the middle is a large park with a small body of water within it's center. The jail, as well as the City Watch's headquarters is also known to be found here."; name = "Caelfall"})
"be" = (/turf/village/wall_vdalion/foundation_left,/turf/village/vdalion_extra/snow_1,/area)
"bf" = (/Building/Warper/Exterior,/turf/village/vdalion_extra/door_bottom,/area)
"bg" = (/turf/village/wall_vdalion/bottom,/BuildingDetails{building_category = "Vdalion"; building_cost = 50000; building_desc = "A modest building with 3 rooms."; building_guild = "Vdalion"; building_name = "VS-Medium House Snow C"; building_settlement_only = 1},/turf/village/horizontal_roof_vdalion/bottom_fill,/area)
"bh" = (/turf/city/wall/blue{icon_state = "Left"},/turf/shop_int/stairs/bottom_left,/Region{desc = "Osrona's merchant district, Caelfall has a high number of shops and large homes for those more well off than the majority of the population. Within the middle is a large park with a small body of water within it's center. The jail, as well as the City Watch's headquarters is also known to be found here."; name = "Caelfall"})
"bi" = (/turf/shop_int/stairs/bottom,/Region{desc = "Osrona's merchant district, Caelfall has a high number of shops and large homes for those more well off than the majority of the population. Within the middle is a large park with a small body of water within it's center. The jail, as well as the City Watch's headquarters is also known to be found here."; name = "Caelfall"})
"bj" = (/turf/city/wall/blue{density = 0; icon_state = "Right"},/turf/shop_int/stairs/bottom_right,/Region{desc = "Osrona's merchant district, Caelfall has a high number of shops and large homes for those more well off than the majority of the population. Within the middle is a large park with a small body of water within it's center. The jail, as well as the City Watch's headquarters is also known to be found here."; name = "Caelfall"})
"bk" = (/obj/generic_shadow/white{alpha = 50; color = "black"; icon_state = "tl_corner"; name = "house shadow corner"},/turf,/area)
"bl" = (/turf/village/wall_vdalion/foundation_middle,/turf/village/vdalion_extra/snow_1,/area)
"bm" = (/SmallPreview/Start,/turf,/area)
"bn" = (/turf/village/wall_vdalion/foundation_right,/turf/village/vdalion_extra/snow_1,/area)
"bo" = (/turf/village/wall_vdalion/foundation_middle,/obj/generic_shadow/white{alpha = 75; color = "black"; icon_state = "full"; name = "house shadow"},/turf/village/vdalion_extra/snow_1,/area)

(1,1,1) = {"
aaaaabababababababacabababababaBaaaaaE
aaaaababababababadaeafabababababaaaaaa
aaaaabababababadagahaiafababababaaaaaa
aaaaababababadagagahaiaiafabababaaaaaa
aaaaabababajagagagakaiaialabababaaaaaa
aaaaabababamagaganaoapaialaqaqaraaaaaa
aaaaasatatauaganavawaoapaiaxaxayaaaaaa
aaaaazaAaAaQanavaCaDaCaoapaxaxayaaaaaa
aaaaazaAaAbdaFaGaHaHaHaHaIaxaxayaaaaaa
aaaaazaAaAaAaJaKaxaxaxaxaxaxaxayaaaaaa
aaaaazaAaAaAaLaMaNaOaPbgaPaOaRaSaaaaaa
aaaaaTaUaVaWaTaTaJaXaCaYaCaXaZabaaaaaa
aaaabebabbbcboblblblblbfblblbnabaaaaaa
aaaabmbhbibjbkabababababababababaaaaaa
"}
