"a" = (/turf/void,/area)
"b" = (/turf,/area)
"c" = (/obj/map/noDenseMarker,/turf/village/roof_vdalion/center_3,/area)
"d" = (/SmallPreview/End,/turf,/area)
"e" = (/obj/map/noDenseMarker,/turf/village/roof_vdalion/left_3,/area)
"f" = (/obj/map/noDenseMarker,/turf/village/roof_vdalion/center_2,/area)
"g" = (/obj/map/noDenseMarker,/turf/village/roof_vdalion/right_3,/area)
"h" = (/turf/village/roof_vdalion/left_2,/area)
"i" = (/turf/village/roof_vdalion/center_2,/area)
"j" = (/turf/village/roof_vdalion/right_2,/area)
"k" = (/obj/map/noDenseMarker,/turf/village/roof_vdalion/left_5,/area)
"l" = (/turf/village/wall_vdalion/bottom,/turf/village/roof_vdalion/center_1,/area)
"m" = (/obj/map/noDenseMarker,/turf/village/roof_vdalion/right_5,/area)
"n" = (/obj/map/noDenseMarker,/turf/village/roof_vdalion/left_6,/area)
"o" = (/turf/village/wall_vdalion/bottom,/turf/village/roof_vdalion/left_1,/turf/village/roof_vdalion/center_3{layer = 7},/area)
"p" = (/turf/village/wall_vdalion/bottom,/turf/village/roof_vdalion/left_4,/turf/village/roof_vdalion/right_4,/area)
"q" = (/turf/village/wall_vdalion/bottom,/turf/village/roof_vdalion/right_1,/area)
"r" = (/obj/map/noDenseMarker,/turf/village/roof_vdalion/right_6,/area)
"s" = (/turf/village/wall_vdalion/bottom,/turf/village/roof_vdalion/right_3,/area)
"t" = (/turf/village/wall_vdalion/bottom,/turf/village/roof_vdalion/right_4,/area)
"u" = (/turf/village/wall_vdalion/bottom_left,/turf/village/roof_vdalion/left_1,/turf/village/roof_vdalion/left_5{layer = 7},/area)
"v" = (/MapLimit,/turf/void,/area)
"w" = (/turf/village/wall_vdalion/bottom,/turf/village/roof_vdalion/right_4,/turf/village/vdalion_extra/windowbig_4,/area)
"x" = (/turf/village/wall_vdalion/bottom_right,/turf/village/roof_vdalion/right_1,/area)
"y" = (/obj/map/noDenseMarker,/turf/village/roof_vdalion/left_7,/area)
"z" = (/turf/village/wall_vdalion/bottom_left,/turf/village/roof_vdalion/left_4,/turf/village/roof_vdalion/left_6,/area)
"A" = (/turf/village/wall_vdalion/bottom_left,/turf/village/roof_vdalion/left_1,/area)
"B" = (/turf/village/wall_vdalion/bottom,/obj/generic_shadow/white{alpha = 50; color = "black"; icon_state = "bl_corner"},/turf/village/roof_vdalion/right_5{layer = 7},/area)
"C" = (/turf/village/wall_vdalion/bottom,/turf/village/roof_vdalion/left_4,/BuildingDetails{building_category = "Vdalion"; building_cost = 25000; building_desc = "A building with 2 rooms."; building_guild = "Vdalion"; building_name = "VS-Small House Snow D"; building_settlement_only = 1},/turf/village/roof_vdalion/right_4,/area)
"D" = (/turf/village/wall_vdalion/bottom,/turf/village/vdalion_extra/windowbig_3,/area)
"E" = (/turf/village/wall_vdalion/bottom_right,/turf/village/roof_vdalion/right_4,/area)
"F" = (/obj/map/noDenseMarker,/turf/village/roof_vdalion/right_7,/area)
"G" = (/turf/village/wall_vdalion/foundation_left,/turf/village/vdalion_extra/snow_1,/turf/village/roof_vdalion/left_7,/area)
"H" = (/turf/village/wall_vdalion/bottom_left,/turf/village/roof_vdalion/left_4,/area)
"I" = (/turf/village/wall_vdalion/bottom,/turf/village/vdalion_extra/door_top,/area)
"J" = (/turf/village/wall_vdalion/bottom,/obj/generic_shadow/white{alpha = 50; color = "black"; icon_state = "full"},/turf/village/roof_vdalion/right_6{layer = 7},/area)
"K" = (/turf/village/wall_vdalion/foundation_middle,/turf/village/vdalion_extra/snow_1,/Region{desc = "Osrona's merchant district, Caelfall has a high number of shops and large homes for those more well off than the majority of the population. Within the middle is a large park with a small body of water within it's center. The jail, as well as the City Watch's headquarters is also known to be found here."; name = "Caelfall"})
"L" = (/turf/village/wall_vdalion/foundation_right,/turf/village/vdalion_extra/snow_1,/Region{desc = "Osrona's merchant district, Caelfall has a high number of shops and large homes for those more well off than the majority of the population. Within the middle is a large park with a small body of water within it's center. The jail, as well as the City Watch's headquarters is also known to be found here."; name = "Caelfall"})
"M" = (/SmallPreview/Start,/turf,/area)
"N" = (/turf/village/wall_vdalion/foundation_left,/turf/village/vdalion_extra/snow_1,/area)
"O" = (/Building/Warper/Exterior,/turf/village/vdalion_extra/door_bottom,/Region{desc = "Osrona's merchant district, Caelfall has a high number of shops and large homes for those more well off than the majority of the population. Within the middle is a large park with a small body of water within it's center. The jail, as well as the City Watch's headquarters is also known to be found here."; name = "Caelfall"})
"P" = (/obj/generic_shadow/white{alpha = 50; color = "black"; icon_state = "tl_corner"},/turf,/area)
"Q" = (/turf/village/wall_vdalion/foundation_middle,/turf/village/vdalion_extra/snow_1,/obj/generic_shadow/white{alpha = 50; color = "black"; icon_state = "full"},/turf/village/roof_vdalion/right_7{layer = 7},/Region{desc = "Osrona's merchant district, Caelfall has a high number of shops and large homes for those more well off than the majority of the population. Within the middle is a large park with a small body of water within it's center. The jail, as well as the City Watch's headquarters is also known to be found here."; name = "Caelfall"})

(1,1,1) = {"
aaaaaaaaaaaaaav
aaabbbbcbbbdaaa
aaabbbefgbbbaaa
aaabbehijgbbaaa
aaabehhijjgbaaa
aaakhhhljjjmaaa
aaanhhopqjjraaa
aaanhhistqjraaa
aaanuhljBwxraaa
aaayzACqJDEFaaa
aaabGHIEQKLbaaa
aaaMbNOLPbbbaaa
aaaaaaaaaaaaaaa
"}
