"aa" = (/turf/void,/area)
"ab" = (/turf,/area)
"ac" = (/obj/map/noDenseMarker,/turf/village/roof_delphinia/center_3,/area)
"ad" = (/SmallPreview/End,/turf,/area)
"ae" = (/obj/map/noDenseMarker,/turf/village/roof_delphinia/left_3,/area)
"af" = (/obj/map/noDenseMarker,/turf/village/roof_delphinia/center_2,/area)
"ag" = (/obj/map/noDenseMarker,/turf/village/roof_delphinia/right_3,/area)
"ah" = (/obj/map/noDenseMarker,/turf/village/horizontal_roof_delphinia/top_left,/area)
"ai" = (/obj/map/noDenseMarker,/turf/village/horizontal_roof_delphinia/top_fill,/area)
"aj" = (/MapLimit,/turf/void,/area)
"ak" = (/turf/village/roof_delphinia/left_2,/turf/village/horizontal_roof_delphinia/top_fill,/area)
"al" = (/turf/village/roof_delphinia/center_2,/turf/village/horizontal_roof_delphinia/top_right,/turf/village/roof_delphinia/center_3{layer = 7},/area)
"am" = (/turf/village/roof_delphinia/right_2,/area)
"an" = (/obj/map/noDenseMarker,/turf/village/horizontal_roof_delphinia/left,/area)
"ao" = (/turf/village/horizontal_roof_delphinia/fill,/area)
"ap" = (/turf/village/horizontal_roof_delphinia/fill,/turf/village/roof_delphinia/left_3{layer = 7},/area)
"aq" = (/turf/village/roof_delphinia/center_2,/area)
"ar" = (/turf/village/roof_delphinia/left_2,/area)
"as" = (/turf/village/roof_delphinia/left_3,/obj/map/noDenseMarker,/turf/village/horizontal_roof_delphinia/top_fill,/area)
"at" = (/obj/map/noDenseMarker,/turf/village/roof_delphinia/right_5,/area)
"au" = (/turf/village/wall_vdalion/top_middle,/turf/village/roof_delphinia/center_1,/area)
"av" = (/turf/village/wall_vdalion/top_middle,/turf/village/roof_delphinia/left_1,/area)
"aw" = (/turf/village/wall_vdalion/top_middle,/turf/village/roof_delphinia/right_4,/turf/village/roof_delphinia/left_4,/area)
"ax" = (/obj/map/noDenseMarker,/turf/village/roof_delphinia/right_6,/area)
"ay" = (/obj/map/noDenseMarker,/turf/village/horizontal_roof_delphinia/bottom_left,/area)
"az" = (/turf/village/wall_vdalion/top_middle,/turf/village/roof_delphinia/right_1,/area)
"aA" = (/turf/village/wall_vdalion/top_left,/turf/village/horizontal_roof_delphinia/bottom_fill,/area)
"aB" = (/turf/village/wall_vdalion/top_middle,/turf/village/horizontal_roof_delphinia/bottom_fill,/area)
"aC" = (/turf/village/wall_vdalion/top_middle,/turf/village/vdalion_extra/windowbig_4,/turf/village/horizontal_roof_delphinia/bottom_fill,/area)
"aD" = (/turf/village/wall_vdalion/top_middle,/turf/village/horizontal_roof_delphinia/bottom_fill,/turf/village/roof_delphinia/left_5,/area)
"aE" = (/turf/village/wall_vdalion/top_middle,/turf/village/roof_delphinia/left_4,/area)
"aF" = (/turf/village/wall_vdalion/top_middle,/area)
"aG" = (/turf/village/wall_vdalion/top_middle,/turf/village/roof_delphinia/right_4,/area)
"aH" = (/turf/village/wall_vdalion/top_left,/area)
"aI" = (/turf/village/wall_vdalion/top_middle,/turf/village/vdalion_extra/windowbig_3,/area)
"aJ" = (/turf/village/wall_vdalion/top_middle,/turf/village/roof_delphinia/left_6,/area)
"aK" = (/turf/village/wall_vdalion/top_left,/turf/village/roof_delphinia/left_1,/area)
"aL" = (/turf/village/wall_vdalion/top_middle,/turf/village/roof_delphinia/left_4,/turf/village/vdalion_extra/windowbig_4,/area)
"aM" = (/turf/village/wall_vdalion/top_middle,/turf/village/roof_delphinia/right_4,/turf/village/vdalion_extra/windowbig_4,/area)
"aN" = (/turf/village/wall_vdalion/top_right,/turf/village/roof_delphinia/right_1,/area)
"aO" = (/turf/village/wall_vdalion/middle_left,/area)
"aP" = (/turf/village/wall_vdalion/middle,/turf/inn/rail/top_left,/area)
"aQ" = (/turf/village/wall_vdalion/middle,/area)
"aR" = (/turf/village/wall_vdalion/middle,/turf/village/vdalion_extra/windowbig_5,/area)
"aS" = (/turf/village/wall_vdalion/middle,/turf/village/roof_delphinia/left_7,/area)
"aT" = (/turf/village/wall_vdalion/top_left,/turf/village/roof_delphinia/left_4,/area)
"aU" = (/obj/map/noDenseMarker,/turf/village/roof_delphinia/right_7,/area)
"aV" = (/turf/village/wall_vdalion/top_right,/turf/village/roof_delphinia/right_4,/area)
"aW" = (/turf/village/wall_vdalion/bottom_left,/area)
"aX" = (/turf/inn/floor,/obj/generic_shadow/white{alpha = 75; color = "black"; icon_state = "top"},/turf/inn/rail/left{layer = 3.2},/area)
"aY" = (/obj/generic_shadow/white{alpha = 75; color = "black"; icon_state = "top"},/turf/inn/floor,/area)
"aZ" = (/turf/village/wall_vdalion/middle,/turf/inn/rail/top_right,/turf/village/vdalion_extra/windowbig_5,/area)
"ba" = (/turf/village/wall_vdalion/middle_right,/area)
"bb" = (/turf/inn/floor,/turf/inn/rail/left{layer = 3.2},/area)
"bc" = (/turf/inn/floor,/area)
"bd" = (/turf/inn/floor,/obj/generic_shadow/white{alpha = 75; color = "black"; icon_state = "top"},/turf/inn/rail/right{layer = 3.2},/area)
"be" = (/obj/generic_shadow/white{alpha = 50; color = "black"; icon_state = "full"},/turf/village/wall_vdalion/bottom_right,/area)
"bf" = (/turf/village/wall_vdalion/foundation_left,/area)
"bg" = (/turf/inn/floor,/turf/inn/rail/middle,/area)
"bh" = (/turf/inn/floor,/turf/shop_int/stairs/top_left,/area)
"bi" = (/turf/inn/floor,/turf/shop_int/stairs/top,/area)
"bj" = (/turf/inn/floor,/turf/shop_int/stairs/top_right,/area)
"bk" = (/turf/village/wall_vdalion/bottom,/area)
"bl" = (/turf/village/wall_vdalion/bottom,/turf/village/vdalion_extra/windowbig_4,/area)
"bm" = (/BuildingDetails{building_category = "Delphina"; building_cost = 50000; building_desc = "An apartment complex."; building_guild = "Delphina"; building_interior = 0; building_name = "D-Apartment"; building_settlement_only = 1},/turf/village/wall_vdalion/bottom,/area)
"bn" = (/turf/shop_int/stairs/left,/area)
"bo" = (/turf/shop_int/stairs/middle,/area)
"bp" = (/turf/shop_int/stairs/right,/area)
"bq" = (/obj/generic_shadow/white{alpha = 50; color = "black"; icon_state = "full"},/turf/village/wall_vdalion/foundation_right,/area)
"br" = (/turf/village/wall_vdalion/bottom,/turf/village/vdalion_extra/windowbig_3,/area)
"bs" = (/turf/village/wall_vdalion/bottom,/turf/village/vdalion_extra/door_top,/area)
"bt" = (/obj/generic_shadow/white{alpha = 50; color = "black"; icon_state = "full"},/turf,/area)
"bu" = (/turf/village/wall_vdalion/foundation_middle,/area)
"bv" = (/Building/Warper/Exterior,/turf/village/vdalion_extra/door_bottom,/area)
"bw" = (/obj/generic_shadow/white{alpha = 50; color = "black"; icon_state = "tl_corner"; name = "house shadow corner"},/turf,/area)
"bx" = (/SmallPreview/Start,/turf,/area)
"by" = (/turf/city/wall/blue{icon_state = "Left"},/turf/shop_int/stairs/bottom_left,/area)
"bz" = (/turf/shop_int/stairs/bottom,/area)
"bA" = (/turf/city/wall/blue{density = 0; icon_state = "Right"},/turf/shop_int/stairs/bottom_right,/area)
"bB" = (/turf/inn/floor,/turf/inn/rail/bottom_left,/area)
"bC" = (/turf/inn/floor,/turf/inn/rail/bottom_right,/area)

(1,1,1) = {"
aaababababababababababababababacabababadaj
aaabababababababababababababaeafagabababaa
aaahaiaiaiaiaiaiaiaiaiaiaiasakalamagababaa
aaanaoaoaoaoaoaoaoaoaoaoaoaoapaqamamagabaa
aaanaoaoaoaoaoaoaoaoaoaoaoaparauamamamataa
aaanaoaoaoaoaoaoaoaoaoaoaparavawazamamaxaa
aaayaAaBaBaCaBaCaBaCaBaDaravaEaFaGazamaxaa
aaabaHaFaFaIaFaIaFaIaFaJaKaLaFaFaFaMaNaxaa
aaabaOaPaQaRaQaRaQaRaQaSaTaIaFaFaFaIaVaUaa
aaabaWaXaYaYaYaYaYaYaYaYaOaRaQaQaQaZbaabaa
aaabaWbbbcbcbcbcbcbcbcbcaYaYaYaYaYbdbeabaa
aaabbfbBbgbgbgbgbgbgbgbgbgbgbhbibjbCbeabaa
aaababaWbkblbkblbkblbkblbmbkbnbobpbebqabaa
aaababaWbkbrbkbrbkbrbkbrbsbkbnbobpbebtabaa
aaababbfbububububububububvbubnbobpbqbwabaa
aabxababababababababababababbybzbAbwababaa
aaaaaaaaaaaaaaaaaaaaaaaaaaaaaaaaaaaaaaaaaa
"}
