"aa" = (/turf,/area)
"ab" = (/obj/map/noDenseMarker,/turf/village/roof_delphinia/center_3,/area)
"ac" = (/obj/map/noDenseMarker,/turf/village/roof_delphinia/left_3,/area)
"ad" = (/obj/map/noDenseMarker,/turf/village/roof_delphinia/center_2,/area)
"ae" = (/obj/map/noDenseMarker,/turf/village/roof_delphinia/right_3,/area)
"af" = (/turf/village/roof_delphinia/left_2,/area)
"ag" = (/turf/village/roof_delphinia/center_2,/area)
"ah" = (/turf/village/roof_delphinia/right_2,/area)
"ai" = (/obj/map/noDenseMarker,/turf/village/horizontal_roof_delphinia/top_left,/area)
"aj" = (/obj/map/noDenseMarker,/turf/village/horizontal_roof_delphinia/top_fill,/area)
"ak" = (/SmallPreview/End,/turf,/area)
"al" = (/turf/village/roof_delphinia/left_2,/turf/village/horizontal_roof_delphinia/top_fill,/area)
"am" = (/turf/village/roof_delphinia/center_2,/turf/village/horizontal_roof_delphinia/top_middle,/turf/village/roof_delphinia/center_3{layer = 7},/area)
"an" = (/turf/village/roof_delphinia/right_2,/turf/village/horizontal_roof_delphinia/top_fill,/area)
"ao" = (/MapLimit,/turf,/area)
"ap" = (/obj/map/noDenseMarker,/turf/village/horizontal_roof_delphinia/top_right,/area)
"aq" = (/obj/map/noDenseMarker,/turf/village/horizontal_roof_delphinia/left,/area)
"ar" = (/turf/village/horizontal_roof_delphinia/fill,/area)
"as" = (/turf/village/horizontal_roof_delphinia/fill,/turf/village/roof_delphinia/left_3{layer = 7},/area)
"at" = (/turf/village/horizontal_roof_delphinia/fill,/turf/village/roof_delphinia/right_3{layer = 7},/area)
"au" = (/obj/map/noDenseMarker,/turf/village/horizontal_roof_delphinia/right,/area)
"av" = (/obj/map/noDenseMarker,/turf/village/roof_delphinia/left_5,/area)
"aw" = (/turf/village/roof_delphinia/center_2,/turf/village/horizontal_roof_delphinia/top_left,/turf/village/roof_delphinia/center_3{layer = 7},/area)
"ax" = (/turf/village/roof_delphinia/left_3,/obj/map/noDenseMarker,/turf/village/horizontal_roof_delphinia/top_fill,/area)
"ay" = (/turf/village/roof_delphinia/right_3,/obj/map/noDenseMarker,/turf/village/horizontal_roof_delphinia/top_fill,/area)
"az" = (/turf/village/roof_delphinia/right_5,/obj/map/noDenseMarker,/turf/village/horizontal_roof_delphinia/top_fill,/area)
"aA" = (/turf/village/roof_delphinia/center_2,/turf/village/horizontal_roof_delphinia/top_right,/turf/village/roof_delphinia/center_3{layer = 7},/area)
"aB" = (/obj/map/noDenseMarker,/turf/village/roof_delphinia/right_5,/area)
"aC" = (/turf/village/wall_vdalion/top_middle,/turf/village/roof_delphinia/center_1,/area)
"aD" = (/turf/inn/rail/middle,/turf/village/horizontal_roof_delphinia/right,/area)
"aE" = (/turf/inn/rail/middle,/turf/village/horizontal_roof_delphinia/left,/area)
"aF" = (/turf/village/roof_delphinia/left_5,/obj/map/noDenseMarker,/turf/village/horizontal_roof_delphinia/top_fill,/area)
"aG" = (/turf/village/wall_vdalion/top_middle,/turf/village/roof_delphinia/left_1,/area)
"aH" = (/turf/village/wall_vdalion/top_middle,/turf/village/roof_delphinia/right_4,/turf/village/roof_delphinia/left_4,/area)
"aI" = (/obj/map/noDenseMarker,/turf/village/roof_delphinia/left_6,/area)
"aJ" = (/obj/map/noDenseMarker,/turf/village/roof_delphinia/right_6,/area)
"aK" = (/turf/village/wall_vdalion/top_middle,/turf/village/roof_delphinia/right_1,/area)
"aL" = (/turf/inn/floor,/obj/generic_shadow/white{alpha = 50; color = "black"; icon_state = "full"},/turf/village/horizontal_roof_delphinia/right,/area)
"aM" = (/turf/inn/floor,/obj/generic_shadow/white{alpha = 50; color = "black"; icon_state = "full"},/turf/village/horizontal_roof_delphinia/left,/area)
"aN" = (/turf/village/wall_vdalion/top_left,/turf/village/roof_delphinia/left_1,/area)
"aO" = (/turf/village/wall_vdalion/top_middle,/turf/village/roof_delphinia/left_4,/area)
"aP" = (/turf/village/wall_vdalion/top_middle,/turf/village/vdalion_extra/windowbig_4,/area)
"aQ" = (/turf/village/wall_vdalion/top_middle,/turf/village/roof_delphinia/right_4,/area)
"aR" = (/turf/village/wall_vdalion/top_right,/turf/village/roof_delphinia/right_1,/area)
"aS" = (/turf/village/wall_vdalion/bottom_right,/turf/village/roof_delphinia/right_5,/obj/generic_shadow/white{alpha = 50; color = "black"; icon_state = "full"},/turf/village/horizontal_roof_delphinia/bottom_fill,/area)
"aT" = (/turf/inn/floor,/obj/generic_shadow/white{alpha = 50; color = "black"; icon_state = "full"},/turf/village/horizontal_roof_delphinia/bottom_right,/area)
"aU" = (/turf/inn/floor,/obj/generic_shadow/white{alpha = 50; color = "black"; icon_state = "tl_corner"},/turf/village/horizontal_roof_delphinia/bottom_left,/area)
"aV" = (/turf/village/wall_vdalion/bottom_left,/turf/village/horizontal_roof_delphinia/bottom_fill,/turf/village/roof_delphinia/left_5{layer = 7},/area)
"aW" = (/turf/village/wall_vdalion/top_left,/turf/village/roof_delphinia/left_4,/area)
"aX" = (/turf/village/wall_vdalion/top_middle,/area)
"aY" = (/turf/village/wall_vdalion/top_middle,/turf/village/vdalion_extra/windowbig_3,/area)
"aZ" = (/turf/village/wall_vdalion/top_right,/turf/village/roof_delphinia/right_4,/area)
"ba" = (/turf/village/wall_vdalion/top_middle,/turf/village/vdalion_extra/windowbig_4,/turf/village/roof_delphinia/right_4,/turf/village/roof_delphinia/left_4,/area)
"bb" = (/turf/village/wall_vdalion/foundation_right,/obj/generic_shadow/white{alpha = 50; color = "black"; icon_state = "full"},/turf/village/roof_delphinia/right_6{layer = 7},/area)
"bc" = (/obj/generic_shadow/white{alpha = 50; color = "black"; icon_state = "tl_corner"},/turf/inn/floor,/area)
"bd" = (/turf/inn/floor,/area)
"be" = (/turf/village/wall_vdalion/foundation_left,/turf/village/roof_delphinia/left_6{layer = 3},/area)
"bf" = (/turf/village/wall_vdalion/top_left,/area)
"bg" = (/turf/village/wall_vdalion/top_middle,/turf/village/vdalion_extra/windowbig_5,/area)
"bh" = (/turf/village/wall_vdalion/top_right,/area)
"bi" = (/turf/inn/floor,/obj/generic_shadow/white{alpha = 50; color = "black"; icon_state = "full"},/obj/generic_shadow/white{alpha = 75; color = "black"; icon_state = "top"},/turf/village/roof_delphinia/right_6{layer = 7},/area)
"bj" = (/turf/inn/floor,/obj/generic_shadow/white{alpha = 75; color = "black"; icon_state = "top"},/turf/village/roof_delphinia/left_7,/area)
"bk" = (/turf/village/wall_vdalion/middle_left,/turf/village/roof_delphinia/left_4,/area)
"bl" = (/turf/village/wall_vdalion/middle,/turf/inn/rail/top_right,/area)
"bm" = (/obj/generic_shadow/white{alpha = 50; color = "black"; icon_state = "bl_corner"},/turf/village/wall_vdalion/middle_left,/area)
"bn" = (/turf/village/wall_vdalion/middle,/area)
"bo" = (/BuildingDetails{building_category = "Delphina"; building_cost = "150000"; building_desc = "A large fort."; building_guild = "Delphina"; building_interior = 0; building_name = "D-Fort"; building_settlement_only = 1},/turf/village/wall_vdalion/middle,/area)
"bp" = (/turf/shop_int/floor,/turf/inn/rail/bottom_right{density = 0; layer = 7},/area)
"bq" = (/turf/village/wall_vdalion/middle_right,/area)
"br" = (/turf/village/wall_vdalion/middle,/turf/inn/rail/top_left,/area)
"bs" = (/turf/village/wall_vdalion/middle_right,/turf/village/roof_delphinia/right_4,/area)
"bt" = (/turf/inn/floor,/obj/generic_shadow/white{alpha = 50; color = "black"; icon_state = "tl_corner"},/obj/generic_shadow/white{alpha = 75; color = "black"; icon_state = "top"},/turf/village/roof_delphinia/right_7{layer = 7},/area)
"bu" = (/turf/inn/floor,/obj/generic_shadow/white{alpha = 75; color = "black"; icon_state = "top"},/turf/village/roof_delphinia/left_6{layer = 3},/area)
"bv" = (/turf/inn/floor,/turf/inn/rail/middle,/obj/generic_shadow/white{alpha = 50; color = "black"; icon_state = "full"},/turf/village/roof_delphinia/right_7{layer = 7},/area)
"bw" = (/turf/inn/floor,/turf/inn/rail/middle,/area)
"bx" = (/obj/generic_shadow/white{alpha = 50; color = "black"; icon_state = "full"},/turf/village/wall_vdalion/bottom_left,/area)
"by" = (/obj/map/noDenseMarker,/turf/village/roof_delphinia/left_7,/area)
"bz" = (/obj/generic_shadow/white{alpha = 50; color = "black"; icon_state = "bl_corner"},/turf/village/wall_vdalion/bottom,/area)
"bA" = (/obj/map/noDenseMarker,/turf/village/roof_delphinia/right_7,/area)
"bB" = (/turf/village/wall_vdalion/bottom,/area)
"bC" = (/turf/village/wall_vdalion/bottom_right,/area)
"bD" = (/turf/inn/floor,/turf/inn/rail/bottom_left,/area)
"bE" = (/turf/inn/floor,/turf/inn/rail/middle,/turf/village/roof_delphinia/left_7,/area)
"bF" = (/obj/generic_shadow/white{alpha = 50; color = "black"; icon_state = "full"},/turf/village/wall_vdalion/top_middle,/area)
"bG" = (/turf/village/wall_vdalion/top_middle,/obj/map/beach/waterfall/middle{alpha = 200},/turf/village/wall_delphinia/top_left{icon_state = "leg"; layer = 41},/area)
"bH" = (/obj/generic_shadow/white{alpha = 50; color = "black"; icon_state = "full"},/turf/village/wall_vdalion/foundation_left,/area)
"bI" = (/obj/map/castle/gate/close,/obj/generic_shadow/white{alpha = 50; color = "black"; icon_state = "full"},/turf/village/wall_vdalion/foundation_middle,/area)
"bJ" = (/Building/Warper/Exterior,/turf/village/wall_vdalion/foundation_middle,/area)
"bK" = (/turf/village/wall_vdalion/foundation_middle,/area)
"bL" = (/turf/village/wall_vdalion/foundation_right,/area)
"bM" = (/obj/generic_shadow/white{alpha = 50; color = "black"; icon_state = "full"},/turf/village/wall_vdalion/middle,/area)
"bN" = (/obj/map/beach/waterfall/middle{alpha = 200},/turf/village/wall_vdalion/top_middle,/area)
"bO" = (/turf/village/wall_vdalion/middle_left,/area)
"bP" = (/obj/generic_shadow/white{alpha = 50; color = "black"; icon_state = "tl_corner"},/obj/generic_shadow/white{alpha = 75; color = "black"; icon_state = "top"},/turf,/area)
"bQ" = (/obj/generic_shadow/white{alpha = 75; color = "black"; icon_state = "top"},/turf/village/road_brown/right,/area)
"bR" = (/obj/generic_shadow/white{alpha = 75; color = "black"; icon_state = "top"},/obj/generic_shadow/white{alpha = 50; color = "black"; icon_state = "tl_corner"},/turf/inn/floor,/area)
"bS" = (/obj/generic_shadow/white{alpha = 75; color = "black"; icon_state = "top"},/turf/village/road_brown/left,/area)
"bT" = (/obj/generic_shadow/white{alpha = 75; color = "black"; icon_state = "top"},/turf/inn/floor,/area)
"bU" = (/turf/village/wall_vdalion/middle,/turf/village/vdalion_extra/windowbig_5,/area)
"bV" = (/obj/generic_shadow/white{alpha = 50; color = "black"; icon_state = "full"},/turf/village/wall_vdalion/bottom,/area)
"bW" = (/obj/generic_shadow/white{alpha = 75; color = "black"; icon_state = "top"},/turf,/area)
"bX" = (/turf/village/wall_delphinia/top_left{icon_state = "leg_left"},/area)
"bY" = (/turf/village/wall_delphinia/top_left{icon_state = "leg"},/area)
"bZ" = (/turf/village/wall_delphinia/top_fill{icon_state = "leg_right"},/area)
"ca" = (/turf/village/road_brown/right,/area)
"cb" = (/turf/beach/ocean/verydeep,/area)
"cc" = (/turf/village/road_brown/left,/area)
"cd" = (/turf/village/wall_vdalion/bottom_left,/area)
"ce" = (/turf/inn/floor,/obj/generic_shadow/white{alpha = 75; color = "black"; icon_state = "top"},/turf/inn/rail/left{layer = 3},/area)
"cf" = (/turf/inn/floor,/obj/generic_shadow/white{alpha = 75; color = "black"; icon_state = "top"},/turf/inn/rail/right{layer = 4},/area)
"cg" = (/turf/village/road_brown/bottom_left,/area)
"ch" = (/turf/village/road_brown/t_l,/area)
"ci" = (/turf/village/road_brown/t_r,/area)
"cj" = (/turf/village/road_brown/bottom_right,/area)
"ck" = (/turf/village/road_brown/b_r,/area)
"cl" = (/turf/village/road_brown/top,/area)
"cm" = (/turf/village/road_brown/b_l,/area)
"cn" = (/obj/generic_shadow/white{alpha = 50; color = "black"; icon_state = "full"},/turf/village/wall_vdalion/foundation_middle,/area)
"co" = (/turf/village/wall_vdalion/foundation_left,/area)
"cp" = (/turf/inn/floor,/turf/inn/rail/left,/area)
"cq" = (/turf/inn/floor,/turf/inn/rail/right,/area)
"cr" = (/obj/generic_shadow/white{alpha = 75; color = "black"; icon_state = "top"},/obj/map/beach/waterfall/bottom,/turf/beach/ocean/verydeep,/area)
"cs" = (/turf/inn/floor,/turf/shop_int/stairs/top_left,/area)
"ct" = (/turf/inn/floor,/turf/shop_int/stairs/top,/area)
"cu" = (/turf/inn/floor,/turf/shop_int/stairs/top_right,/area)
"cv" = (/turf/city/wall/blue{icon_state = "Left"},/turf/shop_int/stairs/bottom_left,/area)
"cw" = (/SmallPreview/Start,/turf,/area)
"cy" = (/turf/shop_int/stairs/bottom,/area)
"cz" = (/turf/city/wall/blue{density = 0; icon_state = "Right"},/turf/shop_int/stairs/bottom_right,/area)

(1,1,1) = {"
aaaaaaaaaaaaaaaaaaaaaaaaaaaaaaaaaaaaaaaaaaaaaaaaaaaaaaaaaaao
aaaaaaaaaaaaaaaaaaaaaaaaaaaaabaaaaaaaaaaaaaaaaaaaaaaaaaaakaa
aaaaaaaaaaaaaaaaaaaaaaaaaaacadaeaaaaaaaaaaaaaaaaaaaaaaaaaaaa
aaaaaaabaaaaaaaaaaaaaaaaacafagahaeaaaaaaaaaaaaaaaaabaaaaaaaa
aaaaacadaeaaaaaaaiajajaxalalamananayajajapaaaaaaacadaeaaaaaa
aaacafagahaeaaaaaqararararasagatararararauaaaaacafagahaeaaaa
avafafawananazapaqarararasafaCahatarararauaiaFalalaAahahaBaa
aIafafagatararaDaEararasafaGaHaKahatararaDaEararasagahahaJaa
aIafafagahataraLaMarasafaNaOaPaQaRahataraLaMarasafagahahaJaa
aIafafaCahahaSaTaUaVafaGaWaXaYaXaZaKahaSaTaUaVafafaCahahaJaa
aIafaGbaaKahbbbcbdbeaNaObfaXbgaXbhaQaRbbbcbdbeafaGbaaKahaJaa
aIaNaOaYaQaRbibdbdbjbkblbmbnbobnbqbrbsbtbdbdbuaNaOaYaQaRaJaa
byaWaXbgaXaZbvbwbwbwbwbpbxbzbBbBbCbDbwbwbwbwbEaWaXbgaXaZbAaa
aabfaXaPaXbhbFbhbGbfaXbhbHbIbJbKbLbfaXbhbGbfaXbfaXaPaXbhaaaa
aabfaXaYaXbhbMbqbNbObrbqbRbTbTbTbTbOblbqbNbObnbfaXaYaXbhaaaa
aabObrbUblbqbVbCbNcdcebTbdbdbdbdbdbTcfbCbNcdbBbObrbUblbqaaaa
aacdcebTcfbCcnbLbNcocpbdbdbdbdbdbdbdcqbLbNcobKcdcebTcfbCaaaa
aacobDbwbpbLbPbQcrbSbDbwcsctctctcubwbpbQcrbSbWcobDbwbpbLaaaa
aaaabXbYbZaaaacacbccbXbYcvcycycyczbYbZcacbccaaaabXbYbZaaaaaa
aaaaaaaaaaaaaacacbcgchaaaaaaaaaaaaaacicjcbccaaaaaaaaaaaaaaaa
aaaaaaaaaaaaaacacbcbccaaaaaaaaaaaaaacacbcbccaaaaaaaaaaaaaaaa
aaaaaaaaaaaaaackclclcmaaaaaaaaaaaaaackclclcmaaaaaaaaaaaaaaaa
cwaaaaaaaaaaaaaaaaaaaaaaaaaaaaaaaaaaaaaaaaaaaaaaaaaaaaaaaaaa
"}
