"aa" = (/turf,/area)
"ab" = (/obj/map/noDenseMarker,/turf/village/roof_delphinia/center_3,/area)
"ac" = (/MapLimit,/SmallPreview/End,/turf,/area)
"ad" = (/obj/map/noDenseMarker,/turf/village/horizontal_roof_delphinia/top_left,/area)
"ae" = (/obj/map/noDenseMarker,/turf/village/horizontal_roof_delphinia/top_fill,/area)
"af" = (/turf/village/roof_delphinia/left_3,/obj/map/noDenseMarker,/turf/village/horizontal_roof_delphinia/top_fill,/area)
"ag" = (/turf/village/roof_delphinia/center_2,/turf/village/horizontal_roof_delphinia/top_middle,/obj/map/noDenseMarker,/turf/village/roof_delphinia/center_3{layer = 7},/area)
"ah" = (/turf/village/roof_delphinia/right_3,/obj/map/noDenseMarker,/turf/village/horizontal_roof_delphinia/top_fill,/area)
"ai" = (/obj/map/noDenseMarker,/turf/village/horizontal_roof_delphinia/top_right,/area)
"aj" = (/obj/map/noDenseMarker,/turf/village/horizontal_roof_delphinia/left,/area)
"ak" = (/turf/village/horizontal_roof_delphinia/fill,/area)
"al" = (/turf/village/horizontal_roof_delphinia/fill,/turf/village/roof_delphinia/left_3{layer = 7},/area)
"am" = (/turf/village/wall_vdalion/bottom,/turf/village/roof_delphinia/center_1,/area)
"an" = (/turf/village/horizontal_roof_delphinia/fill,/turf/village/roof_delphinia/right_3{layer = 7},/area)
"ao" = (/obj/map/noDenseMarker,/turf/village/horizontal_roof_delphinia/right,/area)
"ap" = (/turf/village/wall_vdalion/bottom,/turf/village/roof_delphinia/left_1,/area)
"aq" = (/turf/village/wall_vdalion/bottom,/turf/village/roof_delphinia/right_4,/turf/village/roof_delphinia/left_4,/area)
"ar" = (/turf/village/wall_vdalion/bottom,/turf/village/roof_delphinia/right_1,/area)
"as" = (/turf/inn/rail/right_joiner,/area)
"at" = (/turf/village/horizontal_roof_delphinia/bottom_left,/turf/inn/rail/middle{layer = 1},/area)
"au" = (/turf/village/wall_vdalion/bottom_left,/turf/village/roof_delphinia/left_1,/area)
"av" = (/turf/castle/floor{density = 0},/turf/city/wall/gap{layer = 3},/turf/village/roof_delphinia/left_4{layer = 3},/area)
"aw" = (/turf/village/wall_vdalion/bottom,/area)
"ax" = (/turf/castle/floor{density = 0},/turf/city/wall/gap/right{layer = 3},/turf/village/roof_delphinia/right_4{layer = 3},/area)
"ay" = (/turf/village/wall_vdalion/bottom_right,/turf/village/roof_delphinia/right_1,/area)
"az" = (/turf/village/horizontal_roof_delphinia/bottom_right,/turf/inn/rail/middle{layer = 1},/area)
"aA" = (/turf/inn/rail/left_joiner,/area)
"aB" = (/turf/inn/rail/bottom_right{layer = 1.5},/turf/inn/rail/right_joiner_inner,/area)
"aC" = (/turf/inn/floor,/area)
"aD" = (/turf/village/wall_vdalion/bottom_left,/turf/village/roof_delphinia/left_4,/area)
"aE" = (/turf/village/wall_vdalion/bottom,/turf/village/horizontal_roof_vdalion2/bottom_fill,/area)
"aF" = (/turf/castle/floor{density = 0},/area)
"aG" = (/obj/map/inn/hatch,/Building/Warper/Dynamic{dynamic_id = "delphina_lighthouse_B_hatch3"},/turf/inn/floor,/area)
"aH" = (/turf/village/wall_vdalion/bottom_right,/turf/village/roof_delphinia/right_4,/area)
"aI" = (/turf/inn/rail/bottom_left{layer = 1.5},/turf/inn/rail/left_joiner_inner,/area)
"aJ" = (/obj/DirDensity/west,/turf/inn/floor,/area)
"aK" = (/turf/inn/floor,/turf/inn/rail/left_joiner,/area)
"aL" = (/turf/village/wall_vdalion/bottom_left,/area)
"aM" = (/turf/village/wall_vdalion/bottom_right,/area)
"aN" = (/obj/DirDensity/east,/turf/inn/floor,/area)
"aO" = (/turf/inn/floor,/turf/inn/rail/top_left,/obj/DirDensity/west,/turf/inn/rail/left,/area)
"aP" = (/turf/village/wall_vdalion/foundation_left,/area)
"aQ" = (/turf/village/wall_vdalion/foundation_middle,/area)
"aR" = (/turf/village/wall_vdalion/foundation_right,/area)
"aS" = (/turf/inn/floor,/obj/DirDensity/east,/turf/inn/rail/right,/area)
"aT" = (/turf/inn/floor,/obj/DirDensity/west,/turf/inn/rail/left,/area)
"aU" = (/obj/generic_shadow/white{alpha = 75; color = "black"; icon_state = "top"},/turf/inn/floor,/area)
"aV" = (/turf/inn/floor,/obj/DirDensity/east,/turf/inn/rail/right{layer = 3.2},/area)
"aW" = (/turf/village/horizontal_roof_vdalion2/bottom_left,/area)
"aX" = (/turf/inn/floor,/turf/inn/rail/middle,/area)
"aY" = (/obj/generic_shadow/white{alpha = 75; color = "black"; icon_state = "full"},/turf/village/horizontal_roof_vdalion2/bottom_right,/area)
"aZ" = (/turf/inn/floor,/turf/inn/rail/right_joiner,/area)
"ba" = (/turf/inn/floor,/obj/DirDensity/west,/turf/inn/rail/bottom_left,/area)
"bb" = (/turf/inn/floor,/obj/DirDensity/east,/turf/inn/rail/bottom_right,/area)
"bc" = (/obj/generic_shadow/white{alpha = 75; color = "black"; icon_state = "full"},/turf,/area)
"bd" = (/turf/village/wall_vdalion/bottom,/turf/village/delphinia_extra/window_2,/area)
"be" = (/obj/generic_shadow/white{alpha = 75; color = "black"; icon_state = "full"},/turf/village/wall_vdalion/bottom_right,/area)
"bf" = (/turf/village/wall_vdalion/bottom,/turf/village/delphinia_extra/windowbig_2,/area)
"bg" = (/turf/village/wall_vdalion/bottom,/turf/village/delphinia_extra/windowbig_1,/area)
"bh" = (/turf/village/wall_vdalion/bottom_left,/obj/generic_shadow/white{alpha = 75; color = "black"; icon_state = "full"},/turf/village/horizontal_roof_vdalion2/bottom_fill,/area)
"bi" = (/turf/village/wall_vdalion/bottom,/turf/village/vdalion_extra/door_top,/area)
"bj" = (/obj/generic_shadow/white{alpha = 75; color = "black"; icon_state = "full"},/turf/village/wall_vdalion/foundation_right,/area)
"bk" = (/obj/generic_shadow/white{alpha = 75; color = "black"; icon_state = "tl_corner"},/turf,/area)
"bl" = (/SmallPreview/Start,/turf,/area)
"bm" = (/Building/Warper/Exterior,/turf/village/vdalion_extra/door_bottom,/area)
"bn" = (/BuildingDetails{building_category = "Delphina"; building_cost = 90000; building_desc = "A large lighthouse."; building_guild = "Delphina"; building_name = "D-Lighthouse B"; building_settlement_only = 1; building_watchtower = 1},/turf/village/wall_vdalion/bottom,/area)
"bo" = (/turf/village/wall_vdalion/bottom,/obj/generic_shadow/white{alpha = 75; color = "black"; icon_state = "full"},/turf/village/horizontal_roof_vdalion2/bottom_fill,/area)
"bp" = (/turf/village/wall_vdalion/bottom_right,/obj/generic_shadow/white{alpha = 75; color = "black"; icon_state = "full"},/turf/village/horizontal_roof_vdalion2/bottom_fill,/area)

(1,1,1) = {"
aaaaaaaaaaaaaaabaaaaaaaaaaaaac
aaaaaaaaadaeafagahaeaiaaaaaaaa
aaaaaaaaajakalamanakaoaaaaaaaa
aaaaaaaaajalapaqaranaoaaaaaaaa
aaaaaaasatauavaFaxayazaAaaaaaa
aaaaaaaBaJaDaFaFaFaHaNaIaaaaaa
aaaaaaaOaGaLaEaEaEaMaCaSaaaaaa
aaaaaaaTaCaPaQaQaQaRaCaVaaaaaa
aaaaaabaaKaUaUaUaUaUaZbbaaaaaa
aaaaaaaWbaaXaXaXaXaXbbaYaaaaaa
aaaaaaaabhbhbobobobpbpbcaaaaaa
aaaaaaaaaLaLawbdawaMbebcaaaaaa
aaaaaaaaaLaLawawawaMbebcaaaaaa
aaaaaaaaaLaLawawawaMbebcaaaaaa
aaaaaaaaaLaLawbfawaMbebcaaaaaa
aaaaaaaaaLaLawbgawaMbebcaaaaaa
aaaaaaaaaLaLawawawaMbebcaaaaaa
aaaaaaaaaLaLawawawaMbebcaaaaaa
aaaaaaaaaLaLawbdawaMbebcaaaaaa
aaaaaaaaaLaLawbnawaMbebcaaaaaa
aaaaaaaaaPaLawbiawaMbjbkaaaaaa
blaaaaaaaaaPaQbmaQaRbkaaaaaaaa
"}
