"aa" = (/turf,/area)
"ab" = (/obj/map/noDenseMarker,/turf/village/roof_delphinia/center_3,/area)
"ac" = (/MapLimit,/SmallPreview/End,/turf,/area)
"ad" = (/obj/map/noDenseMarker,/turf/village/roof_delphinia/left_3,/area)
"ae" = (/obj/map/noDenseMarker,/turf/village/roof_delphinia/center_2,/area)
"af" = (/obj/map/noDenseMarker,/turf/village/roof_delphinia/right_3,/area)
"ag" = (/turf/village/roof_delphinia/center_2,/turf/village/horizontal_roof_delphinia/top_left,/turf/village/roof_delphinia/center_3{layer = 7},/area)
"ah" = (/turf/village/roof_delphinia/right_3,/obj/map/noDenseMarker,/turf/village/horizontal_roof_delphinia/top_fill,/area)
"ai" = (/obj/map/noDenseMarker,/turf/village/horizontal_roof_delphinia/top_fill,/area)
"aj" = (/turf/village/horizontal_roof_delphinia/top_fill,/obj/map/noDenseMarker,/turf/village/roof_delphinia/left_3,/area)
"ak" = (/turf/village/roof_delphinia/left_2,/turf/village/horizontal_roof_delphinia/top_fill,/area)
"al" = (/turf/village/roof_delphinia/center_2,/turf/village/roof_delphinia/center_3{layer = 7},/area)
"am" = (/turf/village/roof_delphinia/right_2,/turf/village/horizontal_roof_delphinia/top_fill,/area)
"an" = (/turf/village/horizontal_roof_delphinia/top_fill,/obj/map/noDenseMarker,/turf/village/roof_delphinia/right_3,/area)
"ao" = (/turf/village/roof_delphinia/left_3,/obj/map/noDenseMarker,/turf/village/horizontal_roof_delphinia/top_fill,/area)
"ap" = (/turf/village/roof_delphinia/center_2,/turf/village/horizontal_roof_delphinia/top_right,/turf/village/roof_delphinia/center_3{layer = 7},/area)
"aq" = (/turf/village/roof_delphinia/left_2,/area)
"ar" = (/turf/village/roof_delphinia/center_2,/area)
"as" = (/turf/village/horizontal_roof_delphinia/fill,/turf/village/roof_delphinia/right_3{layer = 7},/area)
"at" = (/turf/village/horizontal_roof_delphinia/fill,/area)
"au" = (/turf/village/horizontal_roof_delphinia/fill,/turf/village/roof_delphinia/left_3{layer = 7},/area)
"av" = (/turf/village/roof_delphinia/right_2,/area)
"aw" = (/obj/map/noDenseMarker,/turf/village/roof_delphinia/left_5,/area)
"ax" = (/turf/village/wall_vdalion/top_middle,/turf/village/roof_delphinia/center_1,/area)
"ay" = (/obj/map/noDenseMarker,/turf/village/roof_delphinia/right_5,/area)
"az" = (/obj/map/noDenseMarker,/turf/village/roof_delphinia/left_6,/area)
"aA" = (/turf/village/horizontal_roof_delphinia/fill,/turf/village/roof_delphinia/right_5{layer = 7},/area)
"aB" = (/turf/village/horizontal_roof_delphinia/fill,/turf/village/roof_delphinia/left_5{layer = 7},/area)
"aC" = (/turf/village/wall_vdalion/top_middle,/turf/village/roof_delphinia/left_1,/area)
"aD" = (/turf/village/wall_vdalion/top_middle,/turf/village/roof_delphinia/right_4,/turf/village/roof_delphinia/left_4,/turf/house/wooden_window{density = 1; icon_state = "pointy_top"},/area)
"aE" = (/turf/village/wall_vdalion/top_middle,/turf/village/roof_delphinia/right_1,/area)
"aF" = (/obj/map/noDenseMarker,/turf/village/roof_delphinia/right_6,/area)
"aG" = (/turf/village/wall_vdalion/top_middle,/turf/village/horizontal_roof_delphinia/bottom_fill,/turf/village/roof_delphinia/right_6{layer = 7},/area)
"aH" = (/turf/village/wall_vdalion/top_middle,/turf/village/horizontal_roof_delphinia/bottom_fill,/turf/village/vdalion_extra/windowbig_3,/area)
"aI" = (/turf/village/wall_vdalion/top_middle,/turf/village/horizontal_roof_delphinia/bottom_fill,/area)
"aJ" = (/turf/village/wall_vdalion/top_right,/turf/village/horizontal_roof_delphinia/bottom_fill,/turf/village/roof_delphinia/left_6{layer = 7},/area)
"aK" = (/turf/academy/wall/middle/left,/turf/village/roof_delphinia/left_1,/area)
"aL" = (/turf/village/wall_vdalion/top_middle,/turf/village/roof_delphinia/left_4,/area)
"aM" = (/turf/village/wall_vdalion/top_middle,/turf/house/wooden_window{icon_state = "pointy_bottom"; layer = 13},/area)
"aN" = (/turf/village/wall_vdalion/top_middle,/turf/village/roof_delphinia/right_4,/area)
"aO" = (/turf/academy/wall/middle/right,/turf/village/roof_delphinia/right_1,/area)
"aP" = (/turf/village/wall_vdalion/top_left,/turf/village/horizontal_roof_delphinia/bottom_fill,/turf/village/roof_delphinia/right_6,/area)
"aQ" = (/turf/village/wall_vdalion/top_middle,/turf/village/horizontal_roof_delphinia/bottom_fill,/turf/village/roof_delphinia/left_6{layer = 7},/area)
"aR" = (/turf/village/wall_vdalion/middle,/turf/village/roof_delphinia/right_6{layer = 7},/area)
"aS" = (/turf/village/wall_vdalion/middle,/turf/village/vdalion_extra/windowbig_5,/area)
"aT" = (/turf/village/wall_vdalion/middle,/area)
"aU" = (/turf/village/wall_vdalion/middle_right,/turf/village/roof_delphinia/left_7{layer = 7},/area)
"aV" = (/turf/academy/wall/middle/left,/turf/village/roof_delphinia/left_4,/area)
"aW" = (/turf/village/wall_vdalion/top_middle,/area)
"aX" = (/turf/village/wall_vdalion/top_middle,/turf/village/delphinia_extra/door_top,/area)
"aY" = (/turf/academy/wall/middle/right,/turf/village/roof_delphinia/right_4,/area)
"aZ" = (/turf/village/wall_vdalion/middle_left,/turf/village/roof_delphinia/right_7,/area)
"ba" = (/turf/village/wall_vdalion/middle,/turf/village/roof_delphinia/left_6{layer = 7},/area)
"bb" = (/turf/inn/floor,/turf/village/roof_delphinia/right_6{layer = 7},/area)
"bc" = (/turf/inn/floor,/area)
"bd" = (/turf/academy/wall/bottom/left,/area)
"be" = (/turf/academy/wall/bottom/middle,/area)
"bf" = (/Building/Warper/Dynamic{dynamic_id = "Balcony-D-Manor"},/turf/village/delphinia_extra/door_bottom,/area)
"bg" = (/turf/academy/wall/bottom/right,/area)
"bh" = (/turf/inn/floor,/turf/village/roof_delphinia/left_6{layer = 7},/area)
"bi" = (/turf/village/wall_vdalion/top_middle,/turf/village/roof_delphinia/right_4,/turf/village/roof_delphinia/left_4,/area)
"bj" = (/turf/village/wall_vdalion/top_left,/turf/village/roof_delphinia/left_1,/area)
"bk" = (/turf/village/wall_vdalion/top_right,/turf/village/roof_delphinia/right_1,/area)
"bl" = (/turf/inn/floor,/turf/inn/rail/middle,/turf/village/horizontal_roof_delphinia/top_fill,/obj/generic_shadow/white{alpha = 50; color = "black"; icon_state = "full"},/turf/village/roof_delphinia/right_6{layer = 7},/area)
"bm" = (/turf/inn/floor,/turf/inn/rail/middle,/turf/village/horizontal_roof_delphinia/top_fill,/area)
"bn" = (/turf/inn/floor,/turf/inn/rail/middle,/turf/village/horizontal_roof_delphinia/top_fill,/turf/village/roof_delphinia/left_6{layer = 7},/area)
"bo" = (/turf/village/roof_delphinia/left_7,/area)
"bp" = (/turf/village/wall_vdalion/top_left,/turf/village/roof_delphinia/left_4,/area)
"bq" = (/turf/village/wall_vdalion/top_right,/turf/village/roof_delphinia/right_4,/area)
"br" = (/turf/village/horizontal_roof_delphinia/fill,/obj/ColiseumSilver/ColumnSilver/top,/turf/village/roof_delphinia/right_7{layer = 7},/area)
"bs" = (/turf/village/horizontal_roof_delphinia/fill,/obj/ColiseumSilver/ColumnSilver/top,/turf/village/roof_delphinia/left_7{layer = 7},/area)
"bt" = (/obj/map/noDenseMarker,/turf/village/roof_delphinia/right_7,/area)
"bu" = (/turf/village/wall_vdalion/top_left,/area)
"bv" = (/obj/map/academy/window/window_1,/turf/village/wall_vdalion/top_middle,/area)
"bw" = (/turf/village/wall_vdalion/top_right,/area)
"bx" = (/turf/village/wall_vdalion/top_middle,/obj/ColiseumSilver/ColumnSilver/middle/three,/turf/village/horizontal_roof_delphinia/bottom_fill,/area)
"by" = (/turf/village/wall_vdalion/top_right,/turf/village/horizontal_roof_delphinia/bottom_fill,/area)
"bz" = (/turf/academy/wall/middle/left,/turf/village/horizontal_roof_delphinia/bottom_fill,/area)
"bA" = (/turf/academy/wall/middle/right,/turf/village/horizontal_roof_delphinia/bottom_fill,/area)
"bB" = (/turf/village/wall_vdalion/top_left,/turf/village/horizontal_roof_delphinia/bottom_fill,/area)
"bC" = (/turf/village/wall_vdalion/top_middle,/turf/village/horizontal_roof_delphinia/bottom_fill,/turf/house/wooden_window{density = 1; icon_state = "pointy_top"},/area)
"bD" = (/obj/ColiseumSilver/ColumnSilver/middle/two,/turf/village/wall_vdalion/top_middle,/area)
"bE" = (/turf/academy/wall/middle/left,/area)
"bF" = (/turf/academy/wall/middle/right,/area)
"bG" = (/obj/ColiseumSilver/ColumnSilver/middle/two,/turf/village/wall_vdalion/middle,/area)
"bH" = (/turf/village/wall_vdalion/middle_right,/turf/inn/rail/top_left,/area)
"bI" = (/turf/village/wall_vdalion/middle_left,/area)
"bJ" = (/turf/village/wall_vdalion/middle_right,/area)
"bK" = (/turf/village/wall_vdalion/middle_left,/turf/inn/rail/top_right,/area)
"bL" = (/obj/ColiseumSilver/ColumnSilver/middle/two,/turf/village/wall_vdalion/bottom,/area)
"bM" = (/turf/village/wall_vdalion/bottom,/area)
"bN" = (/turf/inn/floor,/turf/inn/rail/left{layer = 3},/area)
"bO" = (/turf/inn/floor,/turf/inn/rail/right{layer = 4},/area)
"bP" = (/obj/ColiseumSilver/ColumnSilver/middle/one,/turf/village/wall_vdalion/foundation_middle,/area)
"bQ" = (/turf/village/wall_vdalion/foundation_middle,/area)
"bR" = (/turf/inn/floor,/turf/inn/rail/left,/area)
"bS" = (/turf/inn/floor,/turf/inn/rail/right,/area)
"bT" = (/turf/village/wall_vdalion/bottom_left,/area)
"bU" = (/turf/village/wall_vdalion/bottom_right,/area)
"bV" = (/obj/ColiseumSilver/ColumnSilver/bottom,/turf,/area)
"bW" = (/turf/inn/floor,/turf/shop_int/stairs/top_left,/area)
"bX" = (/turf/inn/floor,/turf/shop_int/stairs/top,/area)
"bY" = (/turf/inn/floor,/turf/shop_int/stairs/top_right,/area)
"bZ" = (/turf/inn/floor,/turf/inn/rail/middle,/area)
"ca" = (/turf/village/wall_vdalion/foundation_left,/area)
"cb" = (/turf/village/wall_vdalion/foundation_right,/area)
"cc" = (/turf/shop_int/stairs/left,/area)
"cd" = (/turf/shop_int/stairs/middle,/area)
"ce" = (/turf/shop_int/stairs/right,/area)
"cf" = (/SmallPreview/Start,/turf,/area)
"cg" = (/turf/city/wall/blue{icon_state = "Left"},/turf/shop_int/stairs/bottom_left,/area)
"ch" = (/turf/shop_int/stairs/bottom,/area)
"ci" = (/turf/city/wall/blue{density = 0; icon_state = "Right"},/turf/shop_int/stairs/bottom_right,/area)
"cj" = (/turf/village/wall_vdalion/top_middle,/BuildingDetails{building_category = "Delphina"; building_cost = 200000; building_desc = "A large estate."; building_guild = "Delphina"; building_name = "D-Manor"; building_settlement_only = 1},/turf/house/wooden_window{icon_state = "pointy_bottom"; layer = 13},/area)
"ck" = (/Building/Warper/Exterior,/turf/village/delphinia_extra/door_bottom,/area)

(1,1,1) = {"
aaaaaaaaaaaaaaaaaaaaaaaaaaaaaaabaaaaaaaaaaaaaaaaaaaaaaaaaaaaac
aaaaaaabaaaaaaaaaaaaaaaaaaaaadaeafaaaaaaaaaaaaaaaaaaaaabaaaaaa
aaaaadagahaiaiaiaiaiaiaiaiajakalamanaiaiaiaiaiaiaiaiaoapafaaaa
aaadaqarasatatatatatatatatatauarasatatatatatatatatatauaravafaa
awaqaqaravasatatatatatatatauaqaxavasatatatatatatatauaqaravavay
azaqaqaravavaAatatatatataBaqaCaDaEavaAatatatatataBaqaqaravavaF
azaqaqaravavaGaHaIaHaIaHaJaKaLaMaNaOaPaHaIaHaIaHaQaqaqaravavaF
azaqaqaravavaRaSaTaSaTaSaUaVaWaXaWaYaZaSaTaSaTaSbaaqaqaravavaF
azaqaqaravavbbbcbcbcbcbcbcbdbebfbebgbcbcbcbcbcbcbhaqaqaravavaF
azaqaqaxavavbbbcbcbcbcbcbcbcbcbcbcbcbcbcbcbcbcbcbhaqaqaxavavaF
azaqaCbiaEavbbbcbcbcbcbcbcbcbcbcbcbcbcbcbcbcbcbcbhaqaCbiaEavaF
azbjaLaWaNbkblbmbmbmbmbmbmbmbmbmbmbmbmbmbmbmbmbmbnbjaLaWaNbkaF
bobpaWaWaWbqbratatatatatatatatatatatatatatatatatbsbpaWaWaWbqbt
aabuaWbvaWbwbxaIaIaIbxbybzbAbBbCbybzbAbBbxaIaIaIbxbuaWbvaWbwaa
aabuaWaWaWbwbDaWaWaWbDbwbEbFbucjbwbEbFbubDaWaWaWbDbuaWaWaWbwaa
aabuaWaWaWbwbDaWbvaWbDbwbEbFbuaXbwbEbFbubDaWbvaWbDbuaWaWaWbwaa
aabuaWaWaWbwbGaTaTaTbGbHbdbgbIckbJbdbgbKbGaTaTaTbGbuaWaWaWbwaa
aabuaWbvaWbwbLbMbMbMbLbNbcbcbcbcbcbcbcbObLbMbMbMbLbuaWbvaWbwaa
aabIaTaTaTbJbPbQbQbQbPbRbcbcbcbcbcbcbcbSbPbQbQbQbPbIaTaTaTbJaa
aabTbMbMbMbUbVaaaaaabVbWbXbYbZbZbZbWbXbYbVaaaaaabVbTbMbMbMbUaa
aacabQbQbQcbaaaaaaaaaacccdcebQbQbQcccdceaaaaaaaaaacabQbQbQcbaa
cfaaaaaaaaaaaaaaaaaaaacgchciaaaaaacgchciaaaaaaaaaaaaaaaaaaaaaa
"}
