"aa" = (/turf/void,/area)
"ab" = (/turf,/area)
"ac" = (/obj/map/noDenseMarker,/turf/village/roof_delphinia/center_3{layer = 7},/area)
"ad" = (/obj/map/noDenseMarker,/turf/village/roof_delphinia/left_3,/area)
"ae" = (/obj/map/noDenseMarker,/turf/village/roof_delphinia/center_2,/area)
"af" = (/obj/map/noDenseMarker,/turf/village/roof_delphinia/right_3{layer = 7},/area)
"ag" = (/turf/village/roof_delphinia/left_2,/area)
"ah" = (/turf/village/roof_delphinia/center_2,/area)
"ai" = (/turf/village/roof_delphinia/right_2,/area)
"aj" = (/obj/map/noDenseMarker,/turf/village/roof_delphinia/left_5,/area)
"ak" = (/turf/village/wall_vdalion/bottom,/turf/village/roof_delphinia/center_1,/area)
"al" = (/obj/map/noDenseMarker,/turf/village/roof_delphinia/right_5{layer = 7},/area)
"am" = (/obj/map/noDenseMarker,/turf/village/horizontal_roof_delphinia/top_left,/area)
"an" = (/obj/map/noDenseMarker,/turf/village/horizontal_roof_delphinia/top_fill,/area)
"ao" = (/SmallPreview/End,/turf,/area)
"ap" = (/turf/village/horizontal_roof_delphinia/top_fill,/obj/map/noDenseMarker,/turf/village/roof_delphinia/left_6{layer = 7; name = "left 6_1"},/area)
"aq" = (/turf/village/wall_vdalion/bottom,/turf/village/roof_delphinia/left_1,/area)
"ar" = (/turf/village/wall_vdalion/bottom,/turf/village/roof_delphinia/left_4,/turf/village/roof_delphinia/right_4,/turf/village/vdalion_extra/windowbig_4,/area)
"as" = (/obj/map/noDenseMarker,/turf/village/roof_delphinia/right_6{layer = 7},/area)
"at" = (/obj/map/noDenseMarker,/turf/village/horizontal_roof_delphinia/left,/area)
"au" = (/turf/village/horizontal_roof_delphinia/fill,/area)
"av" = (/turf/village/horizontal_roof_delphinia/fill,/turf/village/roof_delphinia/left_6{layer = 7; name = "left 6_1"},/area)
"aw" = (/turf/village/wall_vdalion/bottom,/turf/village/roof_delphinia/right_1,/area)
"ax" = (/turf/village/wall_vdalion/bottom,/turf/village/roof_delphinia/left_4,/area)
"ay" = (/turf/village/wall_vdalion/bottom,/turf/village/vdalion_extra/windowbig_3,/area)
"az" = (/MapLimit,/turf/void,/area)
"aA" = (/turf/inn/rail/middle,/area)
"aB" = (/turf/inn/rail/middle,/turf/inn/rail/right,/area)
"aC" = (/turf/village/wall_vdalion/bottom,/turf/village/roof_delphinia/right_4,/area)
"aD" = (/turf/inn/rail/middle,/obj/map/noDenseMarker,/turf/village/roof_delphinia/right_6{layer = 7},/area)
"aE" = (/turf/village/wall_vdalion/bottom,/area)
"aF" = (/turf/village/wall_vdalion/bottom,/turf/village/vdalion_extra/windowbig_5,/area)
"aG" = (/turf/inn/floor,/obj/generic_shadow/white{alpha = 75; color = "black"; icon_state = "full"; name = "house shadow"},/obj/map/noDenseMarker,/turf/village/roof_delphinia/right_6{layer = 7},/area)
"aH" = (/turf/inn/floor,/area)
"aI" = (/turf/inn/floor,/turf/inn/rail/right,/area)
"aJ" = (/turf/village/horizontal_roof_delphinia/fill,/turf/village/roof_delphinia/left_7{layer = 7; name = "left 7_1"},/area)
"aK" = (/turf/village/wall_vdalion/bottom_left,/turf/village/horizontal_roof_delphinia/top_fill,/area)
"aL" = (/turf/village/wall_vdalion/bottom,/turf/village/horizontal_roof_delphinia/top_fill,/area)
"aM" = (/turf/village/wall_vdalion/bottom,/turf/village/horizontal_roof_delphinia/top_right,/area)
"aN" = (/turf/village/wall_vdalion/bottom_right,/area)
"aO" = (/turf/inn/floor,/obj/generic_shadow/white{alpha = 75; color = "black"; icon_state = "full"; name = "house shadow"},/obj/map/noDenseMarker,/turf/village/roof_delphinia/right_7{layer = 7},/area)
"aP" = (/turf/village/wall_vdalion/bottom,/obj/generic_shadow/white{alpha = 25; color = "black"; icon_state = "bl_corner"},/turf/village/horizontal_roof_delphinia/right,/area)
"aQ" = (/obj/generic_shadow/white{alpha = 75; color = "black"; icon_state = "full"; name = "house shadow"},/turf/inn/floor,/area)
"aR" = (/turf/village/wall_vdalion/bottom_left,/turf/village/horizontal_roof_delphinia/bottom_fill,/area)
"aS" = (/obj/map/noDenseMarker,/turf/village/horizontal_roof_delphinia/bottom_left,/area)
"aT" = (/turf/village/wall_vdalion/bottom,/turf/village/horizontal_roof_delphinia/bottom_fill,/turf/village/vdalion_extra/windowbig_4,/area)
"aU" = (/turf/village/wall_vdalion/bottom,/turf/village/horizontal_roof_delphinia/bottom_fill,/area)
"aV" = (/turf/village/wall_vdalion/bottom,/BuildingDetails{building_category = "Delphina"; building_cost = 50000; building_desc = "A modest building with 3 rooms."; building_guild = "Delphina"; building_interior = 0; building_name = "D-Medium House C"; building_settlement_only = 1},/turf/village/horizontal_roof_delphinia/bottom_fill,/area)
"aW" = (/turf/village/wall_vdalion/bottom,/turf/village/vdalion_extra/windowbig_4,/turf/village/horizontal_roof_delphinia/bottom_fill,/area)
"aX" = (/turf/village/wall_vdalion/bottom_right,/turf/village/horizontal_roof_delphinia/bottom_fill,/area)
"aY" = (/turf/village/wall_vdalion/foundation_middle,/obj/generic_shadow/white{alpha = 75; color = "black"; icon_state = "full"; name = "house shadow"},/turf/village/horizontal_roof_delphinia/bottom_right,/area)
"aZ" = (/turf/village/wall_vdalion/foundation_right,/area)
"ba" = (/obj/generic_shadow/white{alpha = 50; color = "black"; icon_state = "tl_corner"; name = "house shadow corner"},/turf/inn/floor,/area)
"bb" = (/turf/village/wall_vdalion/bottom_left,/area)
"bc" = (/turf/village/wall_vdalion/bottom,/turf/village/vdalion_extra/door_top,/area)
"bd" = (/turf/inn/floor,/obj/generic_shadow/white{alpha = 75; color = "black"; icon_state = "full"; name = "house shadow"},/turf/inn/rail/middle,/area)
"be" = (/turf/inn/floor,/turf/inn/rail/middle,/area)
"bf" = (/turf/inn/floor,/turf/shop_int/stairs/top_left,/area)
"bg" = (/turf/inn/floor,/turf/shop_int/stairs/top,/area)
"bh" = (/turf/inn/floor,/turf/shop_int/stairs/top_right,/area)
"bi" = (/turf/village/wall_vdalion/foundation_left,/area)
"bj" = (/turf/shop_int/floor,/turf/inn/rail/bottom_right{density = 0; layer = 7},/area)
"bk" = (/turf/village/wall_vdalion/foundation_middle,/area)
"bl" = (/Building/Warper/Exterior,/turf/village/vdalion_extra/door_bottom,/area)
"bm" = (/turf/city/wall/blue{icon_state = "Left"},/turf/shop_int/stairs/bottom_left,/area)
"bn" = (/turf/shop_int/stairs/bottom,/area)
"bo" = (/obj/generic_shadow/white{alpha = 50; color = "black"; icon_state = "tl_corner"; name = "house shadow corner"},/turf/village/wall_delphinia/top_left{icon_state = "leg"},/area)
"bp" = (/turf/village/wall_delphinia/top_left{icon_state = "leg"},/area)
"bq" = (/turf/city/wall/blue{density = 0; icon_state = "Right"},/turf/shop_int/stairs/bottom_right,/area)
"bt" = (/turf/village/wall_delphinia/top_fill{icon_state = "leg_right"},/area)
"bv" = (/SmallPreview/Start,/turf,/area)

(1,1,1) = {"
aaaaaaababababababacababababababaoaaaz
aaaaaaabababababadaeafababababababaaaa
aaaaaaababababadagahaiafabababababaaaa
aaaaaaabababadagagahaiaiafababababaaaa
aaaaaaababajagagagakaiaiaialabababaaaa
aaaaaaamanapagagaqarawaiaiasabababaaaa
aaaaaaatauavagaqaxayaCawaiaDaAaAaBaaaa
aaaaaaatauavaqaxaEaFaEaCawaGaHaHaIaaaa
aaaaaaatauaJaKaLaLaLaLaMaNaOaHaHaIaaaa
aaaaaaatauauauauauauauaPaNaQaHaHaIaaaa
aaaaaaaSaRaTaUaVaUaWaXaYaZbaaHaHaIaaaa
aaaaaaabbbayaEbcaEayaNbdbebfbgbhbjaaaa
aaaaaabvbibkbkblbkbkaZbobpbmbnbqbtaaaa
aaaaaaaaaaaaaaaaaaaaaaaaaaaaaaaaaaaaaa
"}
