"aa" = (/turf/void,/area)
"ab" = (/turf,/area)
"ac" = (/MapLimit,/turf/void,/area)
"ad" = (/obj/map/noDenseMarker,/turf/village/horizontal_roof_delphinia/top_fill,/area)
"ae" = (/turf/village/horizontal_roof_delphinia/top_left,/obj/map/noDenseMarker,/turf/village/roof_delphinia/center_3{layer = 7},/area)
"af" = (/SmallPreview/End,/turf,/area)
"ag" = (/obj/map/noDenseMarker,/turf/village/roof_delphinia/left_3,/area)
"ah" = (/turf/village/roof_delphinia/center_2,/area)
"ai" = (/turf/village/horizontal_roof_delphinia/fill,/turf/village/roof_delphinia/right_3{layer = 7},/area)
"aj" = (/turf/village/horizontal_roof_delphinia/fill,/area)
"ak" = (/turf/village/horizontal_roof_delphinia/fill,/turf/village/roof_delphinia/left_3{layer = 7},/area)
"al" = (/obj/map/noDenseMarker,/turf/village/roof_delphinia/right_3,/area)
"am" = (/turf/village/roof_delphinia/left_2,/area)
"an" = (/turf/village/roof_delphinia/right_2,/area)
"ao" = (/obj/map/noDenseMarker,/turf/village/roof_delphinia/left_5,/area)
"ap" = (/turf/village/horizontal_roof_delphinia/top_right,/obj/map/noDenseMarker,/turf/village/roof_delphinia/center_3{layer = 7},/area)
"aq" = (/turf/village/wall_vdalion/bottom_left,/turf/village/roof_delphinia/right_5{layer = 7},/obj/generic_shadow/white{alpha = 50; color = "black"; icon_state = "full"},/turf/village/horizontal_roof_delphinia/bottom_fill,/area)
"ar" = (/turf/village/wall_vdalion/bottom,/turf/village/horizontal_roof_delphinia/bottom_fill,/area)
"as" = (/turf/village/wall_vdalion/bottom,/turf/village/vdalion_extra/door_top,/turf/village/horizontal_roof_delphinia/bottom_fill,/area)
"at" = (/obj/map/noDenseMarker,/turf/village/roof_delphinia/right_5,/area)
"au" = (/obj/map/noDenseMarker,/turf/village/roof_delphinia/left_6,/area)
"av" = (/turf/village/wall_vdalion/bottom_right,/turf/village/roof_delphinia/left_5{layer = 7},/turf/village/horizontal_roof_delphinia/bottom_fill,/area)
"aw" = (/turf/village/wall_vdalion/bottom,/turf/village/roof_delphinia/center_1,/area)
"ax" = (/turf/village/wall_vdalion/foundation_left,/obj/generic_shadow/white{alpha = 50; color = "black"; icon_state = "full"},/turf/village/roof_delphinia/right_6{layer = 7},/area)
"ay" = (/turf/village/wall_vdalion/foundation_middle,/area)
"az" = (/Building/Warper/Exterior,/turf/village/vdalion_extra/door_bottom,/area)
"aA" = (/obj/map/noDenseMarker,/turf/village/roof_delphinia/right_6,/area)
"aB" = (/turf/village/wall_vdalion/foundation_right,/turf/village/roof_delphinia/left_6{layer = 3},/area)
"aC" = (/turf/village/wall_vdalion/bottom,/turf/village/roof_delphinia/left_1,/area)
"aD" = (/turf/village/wall_vdalion/bottom,/turf/village/roof_delphinia/left_4,/turf/village/roof_delphinia/right_4,/area)
"aE" = (/turf/village/wall_vdalion/bottom,/turf/village/roof_delphinia/right_1,/area)
"aF" = (/turf/inn/floor,/obj/generic_shadow/white{alpha = 75; color = "black"; icon_state = "top"},/obj/generic_shadow/white{alpha = 50; color = "black"; icon_state = "full"},/turf/village/roof_delphinia/right_6{layer = 7},/area)
"aG" = (/obj/generic_shadow/white{alpha = 75; color = "black"; icon_state = "top"},/turf/inn/floor,/area)
"aH" = (/turf/inn/floor,/obj/generic_shadow/white{alpha = 75; color = "black"; icon_state = "top"},/turf/village/roof_delphinia/left_6{layer = 3},/area)
"aI" = (/turf/village/wall_vdalion/bottom,/turf/village/roof_delphinia/left_4,/area)
"aJ" = (/turf/village/wall_vdalion/bottom,/area)
"aK" = (/turf/village/wall_vdalion/bottom,/turf/village/roof_delphinia/right_4,/area)
"aL" = (/turf/inn/floor,/obj/generic_shadow/white{alpha = 50; color = "black"; icon_state = "full"},/turf/village/roof_delphinia/right_6{layer = 7},/area)
"aM" = (/turf/inn/floor,/area)
"aN" = (/turf/inn/floor,/turf/village/roof_delphinia/left_6{layer = 3},/area)
"aO" = (/turf/village/wall_vdalion/bottom_left,/turf/village/roof_delphinia/left_1,/area)
"aP" = (/turf/village/wall_vdalion/bottom,/turf/village/roof_delphinia/left_4,/turf/village/vdalion_extra/windowbig_4,/area)
"aQ" = (/turf/village/wall_vdalion/bottom,/turf/village/roof_delphinia/right_4,/turf/village/vdalion_extra/windowbig_4,/area)
"aR" = (/turf/village/wall_vdalion/bottom_right,/turf/village/roof_delphinia/right_1,/area)
"aS" = (/turf/inn/floor,/turf/inn/rail/middle,/obj/generic_shadow/white{alpha = 50; color = "black"; icon_state = "full"},/turf/village/roof_delphinia/right_6{layer = 7},/area)
"aT" = (/obj/map/noDenseMarker,/turf/village/roof_delphinia/left_7,/area)
"aU" = (/turf/inn/floor,/turf/shop_int/stairs/top_left,/area)
"aV" = (/turf/inn/floor,/BuildingDetails{building_category = "Delphina"; building_cost = 50000; building_desc = "A modest building with 3 rooms."; building_guild = "Delphina"; building_interior = 0; building_name = "D-Medium House"; building_settlement_only = 1},/turf/shop_int/stairs/top,/area)
"aW" = (/obj/map/noDenseMarker,/turf/village/roof_delphinia/right_7,/area)
"aX" = (/turf/inn/floor,/turf/shop_int/stairs/top_right,/area)
"aY" = (/turf/inn/floor,/turf/inn/rail/middle,/turf/village/roof_delphinia/left_6{layer = 3},/area)
"aZ" = (/turf/village/wall_vdalion/bottom_left,/turf/village/roof_delphinia/left_4,/area)
"ba" = (/turf/village/wall_delphinia/top_left{icon_state = "leg"},/turf/village/roof_delphinia/right_7{layer = 7},/area)
"bb" = (/turf/village/wall_vdalion/bottom,/turf/village/vdalion_extra/windowbig_3,/area)
"bc" = (/turf/village/wall_vdalion/bottom_right,/turf/village/roof_delphinia/right_4,/area)
"bd" = (/turf/shop_int/stairs/left,/area)
"be" = (/turf/village/wall_delphinia/top_left{icon_state = "leg"},/turf/village/roof_delphinia/left_7,/area)
"bf" = (/turf/shop_int/stairs/middle,/area)
"bg" = (/turf/shop_int/stairs/right,/area)
"bh" = (/turf/village/wall_vdalion/foundation_left,/area)
"bi" = (/turf/village/wall_vdalion/foundation_right,/area)
"bj" = (/turf/city/wall/blue{icon_state = "Left"},/turf/shop_int/stairs/bottom_left,/area)
"bk" = (/turf/shop_int/stairs/bottom,/area)
"bl" = (/turf/city/wall/blue{density = 0; icon_state = "Right"},/turf/shop_int/stairs/bottom_right,/area)
"bn" = (/SmallPreview/Start,/turf,/area)

(1,1,1) = {"
aaaaaaaaaaaaaaaaaaaaaaaaaaaaaaaaaaaaaaaaaaaaaaaaac
aaaaababababaeadadadadadadadadadadadapabababafaaaa
aaaaabababagahaiajajajajajajajajajakahalabababaaaa
aaaaababagamahanaiajajajajajajajakamahanalababaaaa
aaaaabagamamahananaiajajajajajakamamahananalabaaaa
aaaaaoamamamahanananaqarasaravamamamahanananataaaa
aaaaauamamamawanananaxayazayaBamamamawanananaAaaaa
aaaaauamamaCaDaEananaFaGaGaGaHamamaCaDaEananaAaaaa
aaaaauamaCaIaJaKaEanaLaMaMaMaNamaCaIaJaKaEanaAaaaa
aaaaauaOaPaJaJaJaQaRaSaUaVaXaYaCaPaJaJaJaQaEaAaaaa
aaaaaTaZbbaJaJaJbbbcbabdbfbgbeaZbbaJaJaJbbbcaWaaaa
aaaaabbhayayayayaybiabbjbkblabbhayayayayaybiabaaaa
aaaabnababababababababababababababababababababaaaa
aaaaaaaaaaaaaaaaaaaaaaaaaaaaaaaaaaaaaaaaaaaaaaaaaa
"}
