"a" = (/turf/void,/area)
"b" = (/turf,/area)
"c" = (/obj/map/noDenseMarker,/turf/village/roof_delphinia/center_3,/area)
"d" = (/obj/map/noDenseMarker,/turf/village/roof_delphinia/left_3,/area)
"e" = (/obj/map/noDenseMarker,/turf/village/roof_delphinia/center_2,/area)
"f" = (/obj/map/noDenseMarker,/turf/village/roof_delphinia/right_3,/area)
"g" = (/turf/village/roof_delphinia/left_2,/area)
"h" = (/turf/village/roof_delphinia/center_2,/area)
"i" = (/turf/village/roof_delphinia/right_2,/area)
"j" = (/obj/map/noDenseMarker,/turf/village/roof_delphinia/left_5,/area)
"k" = (/turf/village/wall_vdalion/bottom,/turf/village/roof_delphinia/center_1,/area)
"l" = (/obj/map/noDenseMarker,/turf/village/roof_delphinia/right_5,/area)
"m" = (/obj/map/noDenseMarker,/turf/village/roof_delphinia/left_6,/area)
"n" = (/turf/village/wall_vdalion/bottom,/turf/village/roof_delphinia/left_1,/area)
"o" = (/turf/village/wall_vdalion/bottom,/turf/village/roof_delphinia/right_4,/turf/village/roof_delphinia/left_4,/area)
"p" = (/turf/village/wall_vdalion/bottom,/turf/village/roof_delphinia/right_1,/turf/village/roof_delphinia/center_3,/area)
"q" = (/obj/map/noDenseMarker,/turf/village/roof_delphinia/right_6,/area)
"r" = (/turf/village/wall_vdalion/bottom,/turf/village/roof_delphinia/left_4,/area)
"s" = (/turf/village/wall_vdalion/bottom,/turf/village/roof_delphinia/left_3,/area)
"t" = (/turf/village/roof_delphinia/right_2,/turf/village/roof_delphinia/right_3,/area)
"u" = (/turf/village/wall_vdalion/bottom_left,/turf/village/roof_delphinia/left_1,/area)
"v" = (/turf/village/wall_vdalion/bottom,/turf/village/roof_delphinia/left_4,/turf/village/vdalion_extra/windowbig_4,/area)
"w" = (/MapLimit,/turf/void,/area)
"x" = (/obj/map/noDenseMarker,/turf/village/roof_delphinia/left_7,/area)
"y" = (/turf/village/wall_vdalion/bottom,/turf/village/roof_delphinia/left_5,/area)
"z" = (/turf/village/wall_vdalion/bottom_right,/turf/village/roof_delphinia/right_1,/obj/generic_shadow/white{alpha = 50; color = "black"; icon_state = "bl_corner"},/turf/village/roof_delphinia/right_5{layer = 7},/area)
"A" = (/turf/village/wall_vdalion/bottom_left,/turf/village/roof_delphinia/left_4,/area)
"B" = (/SmallPreview/End,/turf,/area)
"C" = (/turf/village/wall_vdalion/bottom,/turf/village/vdalion_extra/windowbig_3,/area)
"D" = (/turf/village/wall_vdalion/bottom,/turf/village/roof_delphinia/left_6,/area)
"E" = (/obj/map/noDenseMarker,/turf/village/roof_delphinia/right_7,/area)
"F" = (/turf/village/wall_vdalion/bottom,/turf/village/roof_delphinia/left_4,/BuildingDetails{building_category = "Delphina"; building_cost = 25000; building_desc = "A building with 2 rooms."; building_guild = "Delphina"; building_name = "D-Small House A"; building_settlement_only = 1},/turf/village/roof_delphinia/right_4,/area)
"G" = (/turf/village/wall_vdalion/bottom_right,/turf/village/roof_delphinia/right_1,/area)
"H" = (/turf/village/wall_vdalion/bottom_right,/turf/village/roof_delphinia/right_4,/obj/generic_shadow/white{alpha = 50; color = "black"; icon_state = "full"},/turf/village/roof_delphinia/right_6{layer = 7},/area)
"I" = (/turf/village/wall_vdalion/foundation_left,/area)
"J" = (/turf/village/wall_vdalion/foundation_middle,/area)
"K" = (/turf/village/wall_vdalion/foundation_middle,/turf/village/roof_delphinia/left_7,/area)
"L" = (/turf/village/wall_vdalion/bottom,/turf/village/vdalion_extra/door_top,/area)
"M" = (/turf/village/wall_vdalion/bottom_right,/turf/village/roof_delphinia/right_4,/area)
"N" = (/obj/generic_shadow/white{alpha = 50; color = "black"; icon_state = "tl_corner"},/turf,/area)
"O" = (/turf/village/wall_vdalion/foundation_right,/obj/generic_shadow/white{alpha = 50; color = "black"; icon_state = "full"},/turf/village/roof_delphinia/right_7,/area)
"P" = (/Building/Warper/Exterior,/turf/village/vdalion_extra/door_bottom,/area)
"Q" = (/SmallPreview/Start,/turf,/area)
"R" = (/turf/village/wall_vdalion/foundation_right,/area)

(1,1,1) = {"
aaaaaaaaaaaaaaaaw
aaaabbbbcbbbBaaaa
aaaabbbdefbbbaaaa
aaaabbdghifbbaaaa
aaaabdgghiifbaaaa
aaaajgggkiiilaaaa
aaaamggnopiiqaaaa
aaaamgnrshtiqaaaa
aaaamuvygkizqaaaa
aaaaxACDuFGHEaaaa
aaaabIJKALMObaaaa
aaaaQbbbIPRNbaaaa
aaaaaaaaaaaaaaaaa
"}
