"a" = (/turf/void,/area)
"b" = (/obj/map/noDenseMarker,/turf/village/horizontal_roof_delphinia/top_left,/area)
"c" = (/obj/map/noDenseMarker,/turf/village/horizontal_roof_delphinia/top_fill,/area)
"d" = (/SmallPreview/End,/obj/map/noDenseMarker,/turf/village/horizontal_roof_delphinia/top_right,/area)
"e" = (/obj/map/noDenseMarker,/turf/village/horizontal_roof_delphinia/left,/area)
"f" = (/turf/village/horizontal_roof_delphinia/fill,/area)
"g" = (/obj/map/noDenseMarker,/turf/village/horizontal_roof_delphinia/right,/area)
"h" = (/turf/inn/rail/middle,/turf/inn/rail/left,/turf/village/horizontal_roof_delphinia/left,/area)
"i" = (/turf/inn/rail/middle,/turf/inn/rail/right,/turf/village/horizontal_roof_delphinia/right,/area)
"j" = (/turf/inn/floor,/turf/inn/rail/left,/turf/village/horizontal_roof_delphinia/bottom_left,/area)
"k" = (/turf/village/wall_vdalion/bottom_left,/turf/village/horizontal_roof_delphinia/bottom_fill,/area)
"l" = (/turf/village/wall_vdalion/bottom,/turf/village/horizontal_roof_delphinia/bottom_fill,/turf/village/vdalion_extra/windowbig_4,/area)
"m" = (/turf/village/wall_vdalion/bottom,/turf/village/horizontal_roof_delphinia/bottom_fill,/area)
"n" = (/MapLimit,/turf/void,/area)
"o" = (/turf/village/wall_vdalion/bottom,/BuildingDetails{building_category = "Delphina"; building_cost = 25000; building_desc = "A building with 2 rooms."; building_guild = "Delphina"; building_name = "D-Small House D"; building_settlement_only = 1},/turf/village/horizontal_roof_delphinia/bottom_fill,/area)
"p" = (/turf/village/wall_vdalion/bottom_right,/turf/village/horizontal_roof_delphinia/bottom_fill,/area)
"q" = (/turf/inn/floor,/turf/inn/rail/right{layer = 3.9},/obj/generic_shadow/white{alpha = 75; color = "black"; icon_state = "full"; name = "house shadow"},/turf/village/horizontal_roof_delphinia/bottom_right,/area)
"r" = (/turf/inn/floor,/turf/inn/rail/left,/area)
"s" = (/turf/village/wall_vdalion/bottom_left,/area)
"t" = (/turf/village/wall_vdalion/bottom,/turf/village/vdalion_extra/windowbig_3,/area)
"u" = (/turf/village/wall_vdalion/bottom,/area)
"v" = (/turf/village/wall_vdalion/bottom,/turf/village/vdalion_extra/door_top,/area)
"w" = (/turf/village/wall_vdalion/bottom_right,/area)
"x" = (/turf/inn/floor,/obj/generic_shadow/white{alpha = 75; color = "black"; icon_state = "full"; name = "house shadow"},/turf/inn/rail/right{layer = 3.9},/area)
"y" = (/turf/village/wall_vdalion/foundation_left,/area)
"z" = (/turf/village/wall_vdalion/foundation_middle,/area)
"A" = (/Building/Warper/Exterior,/turf/village/vdalion_extra/door_bottom,/area)
"B" = (/turf/village/wall_vdalion/foundation_right,/area)
"C" = (/turf/inn/floor,/obj/generic_shadow/white{alpha = 50; color = "black"; icon_state = "tl_corner"; name = "house shadow corner"},/turf/inn/rail/right,/area)
"D" = (/obj/generic_shadow/white{alpha = 75; color = "black"; icon_state = "top"},/turf/inn/floor,/area)
"E" = (/turf/inn/floor,/turf/inn/rail/right,/area)
"F" = (/turf/inn/floor,/turf/inn/rail/middle,/area)
"G" = (/turf/inn/floor,/turf/shop_int/stairs/top_left,/area)
"H" = (/turf/inn/floor,/turf/shop_int/stairs/top,/area)
"I" = (/turf/inn/floor,/turf/shop_int/stairs/top_right,/area)
"J" = (/turf/inn/floor,/turf/inn/rail/bottom_left,/area)
"K" = (/SmallPreview/Start,/turf/village/wall_delphinia/top_left{icon_state = "leg_left"},/area)
"L" = (/turf/village/wall_delphinia/top_left{icon_state = "leg"},/area)
"M" = (/turf/city/wall/blue{icon_state = "Left"},/turf/shop_int/stairs/bottom_left,/area)
"N" = (/turf/shop_int/stairs/bottom,/area)
"O" = (/turf/city/wall/blue{density = 0; icon_state = "Right"},/turf/shop_int/stairs/bottom_right,/area)
"P" = (/turf/village/wall_delphinia/top_fill{icon_state = "leg_right"},/area)
"Q" = (/turf/inn/floor,/turf/inn/rail/bottom_right,/area)

(1,1,1) = {"
aaaaaaaaaaaaaan
aaabcccccccdaaa
aaaefffffffgaaa
aaaefffffffgaaa
aaaefffffffgaaa
aaahfffffffiaaa
aaajklmomlpqaaa
aaarstuvutwxaaa
aaaryzzAzzBCaaa
aaarDDDDDDDEaaa
aaaJFFGHIFFQaaa
aaaKLLMNOLLPaaa
aaaaaaaaaaaaaaa
"}
