"a" = (/turf/void,/area)
"b" = (/turf,/area)
"c" = (/obj/map/noDenseMarker,/turf/village/roof_delphinia/center_3,/area)
"d" = (/obj/map/noDenseMarker,/turf/village/roof_delphinia/left_3,/area)
"e" = (/obj/map/noDenseMarker,/turf/village/roof_delphinia/center_2,/area)
"f" = (/obj/map/noDenseMarker,/turf/village/roof_delphinia/right_3,/area)
"g" = (/turf/village/roof_delphinia/left_2,/area)
"h" = (/turf/village/roof_delphinia/center_2,/area)
"i" = (/turf/village/roof_delphinia/right_2,/area)
"j" = (/obj/map/noDenseMarker,/turf/village/roof_delphinia/left_5,/area)
"k" = (/turf/village/wall_vdalion/bottom,/turf/village/roof_delphinia/center_1,/area)
"l" = (/obj/map/noDenseMarker,/turf/village/roof_delphinia/right_5,/area)
"m" = (/obj/map/noDenseMarker,/turf/village/roof_delphinia/left_6,/area)
"n" = (/turf/village/wall_vdalion/bottom,/turf/village/roof_delphinia/left_1,/area)
"o" = (/turf/village/wall_vdalion/bottom,/turf/village/roof_delphinia/right_4,/turf/village/roof_delphinia/left_4,/area)
"p" = (/turf/village/wall_vdalion/bottom,/turf/village/roof_delphinia/right_1,/area)
"q" = (/obj/map/noDenseMarker,/turf/village/roof_delphinia/right_6,/area)
"r" = (/turf/village/wall_vdalion/bottom,/turf/village/roof_delphinia/left_4,/area)
"s" = (/BuildingDetails{building_category = "Delphina"; building_cost = 25000; building_desc = "A building with 2 rooms."; building_guild = "Delphina"; building_name = "D-Small House"; building_settlement_only = 1},/turf/village/wall_vdalion/bottom,/area)
"t" = (/turf/village/wall_vdalion/bottom,/turf/village/roof_delphinia/right_4,/area)
"u" = (/turf/village/wall_vdalion/bottom_left,/turf/village/roof_delphinia/left_1,/area)
"v" = (/turf/village/wall_vdalion/bottom,/turf/village/vdalion_extra/windowbig_4,/turf/village/roof_delphinia/left_4,/area)
"w" = (/turf/village/wall_vdalion/bottom,/area)
"x" = (/turf/village/wall_vdalion/bottom,/turf/village/vdalion_extra/windowbig_4,/turf/village/roof_delphinia/right_4,/area)
"y" = (/turf/village/wall_vdalion/bottom_right,/turf/village/roof_delphinia/right_1,/area)
"z" = (/obj/map/noDenseMarker,/turf/village/roof_delphinia/left_7,/area)
"A" = (/turf/village/wall_vdalion/bottom_left,/turf/village/roof_delphinia/left_4,/area)
"B" = (/turf/village/wall_vdalion/bottom,/turf/village/vdalion_extra/windowbig_3,/area)
"C" = (/turf/village/wall_vdalion/bottom,/turf/village/vdalion_extra/door_top,/area)
"D" = (/turf/village/wall_vdalion/bottom_right,/turf/village/roof_delphinia/right_4,/area)
"E" = (/obj/map/noDenseMarker,/turf/village/roof_delphinia/right_7,/area)
"F" = (/turf/village/wall_vdalion/foundation_left,/area)
"G" = (/turf/village/wall_vdalion/foundation_middle,/area)
"H" = (/Building/Warper/Exterior,/turf/village/vdalion_extra/door_bottom,/area)
"I" = (/turf/village/wall_vdalion/foundation_right,/area)
"K" = (/MapLimit,/turf/void,/area)
"L" = (/SmallPreview/End,/turf,/area)
"M" = (/SmallPreview/Start,/turf,/area)

(1,1,1) = {"
aaaaaaaaaaaaaaaaK
aaaabbbbcbbbLaaaa
aaaabbbdefbbbaaaa
aaaabbdghifbbaaaa
aaaabdgghiifbaaaa
aaaajgggkiiilaaaa
aaaamggnopiiqaaaa
aaaamgnrstpiqaaaa
aaaamuvwwwxyqaaaa
aaaazABwCwBDEaaaa
aaaaMFGGHGGIbaaaa
aaaaaaaaaaaaaaaaa
aaaaaaaaaaaaaaaaa
"}
