"aa" = (/turf/void,/area)
"ab" = (/turf,/area)
"ac" = (/MapLimit,/turf/void,/area)
"ad" = (/obj/map/noDenseMarker,/turf/village/horizontal_roof_delphinia/top_fill,/area)
"ae" = (/obj/map/noDenseMarker,/turf/village/horizontal_roof_delphinia/top_right,/area)
"af" = (/obj/map/noDenseMarker,/turf/village/roof_delphinia/left_3,/area)
"ag" = (/turf/village/roof_delphinia/center_2,/area)
"ah" = (/turf/village/horizontal_roof_delphinia/fill,/turf/village/roof_delphinia/right_3{layer = 7},/area)
"ai" = (/turf/village/horizontal_roof_delphinia/fill,/area)
"aj" = (/obj/map/noDenseMarker,/turf/village/horizontal_roof_delphinia/right,/area)
"ak" = (/turf/village/roof_delphinia/left_2,/area)
"al" = (/turf/village/roof_delphinia/right_2,/area)
"am" = (/turf/inn/rail/middle,/turf/village/horizontal_roof_delphinia/right,/area)
"an" = (/turf/inn/rail/middle,/area)
"ao" = (/turf/inn/rail/middle,/turf/inn/rail/right,/area)
"ap" = (/obj/map/noDenseMarker,/turf/village/roof_delphinia/left_5,/area)
"aq" = (/turf/village/horizontal_roof_delphinia/top_left,/obj/map/noDenseMarker,/turf/village/roof_delphinia/center_3{layer = 7},/area)
"ar" = (/SmallPreview/End,/turf,/area)
"as" = (/turf/village/wall_vdalion/bottom,/turf/village/horizontal_roof_delphinia/bottom_fill,/obj/generic_shadow/white{alpha = 50; color = "black"; icon_state = "full"},/turf/village/roof_delphinia/right_5{layer = 7},/area)
"at" = (/turf/village/wall_vdalion/bottom,/turf/village/horizontal_roof_delphinia/bottom_fill,/BuildingDetails{building_category = "Delphina"; building_cost = 25000; building_desc = "A building with 2 rooms."; building_guild = "Delphina"; building_name = "D-Small House B"; building_settlement_only = 1},/turf/village/vdalion_extra/door_top,/area)
"au" = (/turf/village/wall_vdalion/bottom_right,/turf/village/horizontal_roof_delphinia/bottom_fill,/area)
"av" = (/turf/inn/floor,/turf/village/horizontal_roof_delphinia/bottom_right,/area)
"aw" = (/obj/map/noDenseMarker,/turf/village/roof_delphinia/left_6,/area)
"ax" = (/turf/inn/floor,/area)
"ay" = (/turf/inn/floor,/turf/inn/rail/right,/area)
"az" = (/turf/village/wall_vdalion/bottom,/turf/village/roof_delphinia/center_1,/area)
"aA" = (/turf/village/wall_vdalion/foundation_middle,/obj/generic_shadow/white{alpha = 50; color = "black"; icon_state = "full"},/turf/village/roof_delphinia/right_6{layer = 7},/area)
"aB" = (/Building/Warper/Exterior,/turf/village/vdalion_extra/door_bottom,/area)
"aC" = (/turf/village/wall_vdalion/foundation_right,/area)
"aD" = (/turf/village/wall_vdalion/bottom,/turf/village/roof_delphinia/left_1,/area)
"aE" = (/turf/village/wall_vdalion/bottom,/turf/village/roof_delphinia/right_4,/turf/village/roof_delphinia/left_4,/area)
"aF" = (/turf/village/wall_vdalion/bottom,/turf/village/roof_delphinia/right_1,/area)
"aG" = (/turf/inn/floor,/obj/generic_shadow/white{alpha = 75; color = "black"; icon_state = "top"},/obj/generic_shadow/white{alpha = 50; color = "black"; icon_state = "full"},/turf/village/roof_delphinia/right_6{layer = 7},/area)
"aH" = (/obj/generic_shadow/white{alpha = 75; color = "black"; icon_state = "top"},/turf/inn/floor,/area)
"aI" = (/turf/village/wall_vdalion/bottom,/turf/village/roof_delphinia/left_4,/area)
"aJ" = (/turf/village/wall_vdalion/bottom,/area)
"aK" = (/turf/village/wall_vdalion/bottom,/turf/village/roof_delphinia/right_4,/area)
"aL" = (/turf/inn/floor,/obj/generic_shadow/white{alpha = 50; color = "black"; icon_state = "full"},/turf/village/roof_delphinia/right_6{layer = 7},/area)
"aM" = (/turf/village/wall_vdalion/bottom_left,/turf/village/roof_delphinia/left_1,/area)
"aN" = (/turf/village/wall_vdalion/bottom,/turf/village/roof_delphinia/left_4,/turf/village/vdalion_extra/windowbig_4,/area)
"aO" = (/turf/village/wall_vdalion/bottom,/turf/village/roof_delphinia/right_4,/turf/village/vdalion_extra/windowbig_4,/area)
"aP" = (/turf/village/wall_vdalion/bottom_right,/turf/village/roof_delphinia/right_1,/area)
"aQ" = (/turf/inn/floor,/turf/inn/rail/middle,/obj/generic_shadow/white{alpha = 50; color = "black"; icon_state = "full"},/turf/village/roof_delphinia/right_6{layer = 7},/area)
"aR" = (/turf/inn/floor,/turf/shop_int/stairs/top_left,/area)
"aS" = (/turf/inn/floor,/turf/shop_int/stairs/top,/area)
"aT" = (/turf/shop_int/floor,/turf/inn/rail/bottom_right{density = 0; layer = 7},/area)
"aU" = (/obj/map/noDenseMarker,/turf/village/roof_delphinia/left_7,/area)
"aV" = (/turf/inn/floor,/turf/shop_int/stairs/top_right,/area)
"aW" = (/turf/inn/floor,/turf/inn/rail/middle,/area)
"aX" = (/turf/village/wall_vdalion/bottom_left,/turf/village/roof_delphinia/left_4,/area)
"aY" = (/turf/village/wall_delphinia/top_left{icon_state = "leg"},/turf/village/roof_delphinia/right_7{layer = 7},/area)
"aZ" = (/turf/village/wall_vdalion/bottom,/turf/village/vdalion_extra/windowbig_3,/area)
"ba" = (/turf/village/wall_vdalion/bottom_right,/turf/village/roof_delphinia/right_4,/area)
"bb" = (/turf/shop_int/stairs/left,/area)
"bc" = (/turf/village/wall_delphinia/top_left{icon_state = "leg"},/area)
"bd" = (/turf/village/wall_delphinia/top_fill{icon_state = "leg_right"},/area)
"be" = (/turf/shop_int/stairs/middle,/area)
"bf" = (/turf/shop_int/stairs/right,/area)
"bg" = (/turf/village/wall_vdalion/foundation_left,/area)
"bh" = (/turf/village/wall_vdalion/foundation_middle,/area)
"bi" = (/turf/city/wall/blue{icon_state = "Left"},/turf/shop_int/stairs/bottom_left,/area)
"bj" = (/turf/shop_int/stairs/bottom,/area)
"bk" = (/turf/city/wall/blue{density = 0; icon_state = "Right"},/turf/shop_int/stairs/bottom_right,/area)
"bn" = (/SmallPreview/Start,/turf,/area)

(1,1,1) = {"
aaaaaaaaaaaaaaaaaaaaaaaaaaaaaaaaac
aaababababaqadadadadadadaeabaraaaa
aaabababafagahaiaiaiaiaiajababaaaa
aaababafakagalahaiaiaiaiajababaaaa
aaabafakakagalalahaiaiaiamanaoaaaa
aaapakakakagalalalasatauavaxayaaaa
aaawakakakazalalalaAaBaCaxaxayaaaa
aaawakakaDaEaFalalaGaHaHaxaxayaaaa
aaawakaDaIaJaKaFalaLaxaxaxaxayaaaa
aaawaMaNaJaJaJaOaPaQaRaSaVaWaTaaaa
aaaUaXaZaJaJaJaZbaaYbbbebfbcbdaaaa
aabnbgbhbhbhbhbhaCabbibjbkababaaaa
aaaaaaaaaaaaaaaaaaaaaaaaaaaaaaaaaa
"}
