"aa" = (/turf/void,/area)
"ab" = (/turf,/area)
"ac" = (/obj/map/noDenseMarker,/turf/village/horizontal_roof_delphinia/top_left,/area)
"ad" = (/obj/map/noDenseMarker,/turf/village/horizontal_roof_delphinia/top_fill,/area)
"ae" = (/MapLimit,/turf/void,/area)
"af" = (/obj/map/noDenseMarker,/turf/village/horizontal_roof_delphinia/left,/area)
"ag" = (/turf/village/horizontal_roof_delphinia/fill,/area)
"ah" = (/turf/village/horizontal_roof_delphinia/fill,/turf/village/roof_delphinia/left_3{layer = 7},/area)
"ai" = (/turf/village/roof_delphinia/center_2,/area)
"aj" = (/obj/map/noDenseMarker,/turf/village/roof_delphinia/right_3,/area)
"ak" = (/turf/village/roof_delphinia/left_2,/area)
"al" = (/turf/village/roof_delphinia/right_2,/area)
"am" = (/turf/inn/rail/middle,/turf/inn/rail/left,/area)
"an" = (/turf/inn/rail/middle,/area)
"ao" = (/turf/inn/rail/middle,/turf/village/horizontal_roof_delphinia/left,/area)
"ap" = (/turf/village/horizontal_roof_delphinia/top_right,/obj/map/noDenseMarker,/turf/village/roof_delphinia/center_3{layer = 7},/area)
"aq" = (/turf/inn/floor,/turf/inn/rail/left,/area)
"ar" = (/turf/inn/floor,/area)
"as" = (/turf/inn/floor,/turf/village/horizontal_roof_delphinia/bottom_left,/area)
"at" = (/turf/village/wall_vdalion/bottom_left,/turf/village/horizontal_roof_delphinia/bottom_fill,/area)
"au" = (/turf/village/wall_vdalion/bottom,/turf/village/horizontal_roof_delphinia/bottom_fill,/BuildingDetails{building_category = "Delphina"; building_cost = 25000; building_desc = "A building with 2 rooms."; building_guild = "Delphina"; building_name = "D-Small House C"; building_settlement_only = 1},/turf/village/vdalion_extra/door_top,/area)
"av" = (/obj/map/noDenseMarker,/turf/village/roof_delphinia/right_5,/area)
"aw" = (/turf/village/wall_vdalion/bottom,/turf/village/horizontal_roof_delphinia/bottom_fill,/turf/village/roof_delphinia/left_5{layer = 7},/area)
"ax" = (/turf/village/wall_vdalion/foundation_left,/area)
"ay" = (/Building/Warper/Exterior,/turf/village/vdalion_extra/door_bottom,/area)
"az" = (/turf/village/wall_vdalion/foundation_middle,/turf/village/roof_delphinia/left_6{layer = 3},/area)
"aA" = (/obj/map/noDenseMarker,/turf/village/roof_delphinia/right_6,/area)
"aB" = (/turf/village/wall_vdalion/bottom,/turf/village/roof_delphinia/center_1,/area)
"aC" = (/SmallPreview/End,/turf,/area)
"aD" = (/obj/generic_shadow/white{alpha = 75; color = "black"; icon_state = "top"},/turf/inn/floor,/area)
"aE" = (/turf/inn/floor,/obj/generic_shadow/white{alpha = 75; color = "black"; icon_state = "top"},/turf/village/roof_delphinia/left_6{layer = 3},/area)
"aF" = (/turf/village/wall_vdalion/bottom,/turf/village/roof_delphinia/left_1,/area)
"aG" = (/turf/village/wall_vdalion/bottom,/turf/village/roof_delphinia/left_4,/turf/village/roof_delphinia/right_4,/area)
"aH" = (/turf/village/wall_vdalion/bottom,/turf/village/roof_delphinia/right_1,/area)
"aI" = (/turf/inn/floor,/turf/village/roof_delphinia/left_6{layer = 3},/area)
"aJ" = (/turf/village/wall_vdalion/bottom,/turf/village/roof_delphinia/left_4,/area)
"aK" = (/turf/village/wall_vdalion/bottom,/area)
"aL" = (/turf/village/wall_vdalion/bottom,/turf/village/roof_delphinia/right_4,/area)
"aM" = (/turf/inn/floor,/turf/inn/rail/middle,/area)
"aN" = (/turf/inn/floor,/turf/shop_int/stairs/top_left,/area)
"aO" = (/turf/inn/floor,/turf/shop_int/stairs/top,/area)
"aP" = (/turf/inn/floor,/turf/shop_int/stairs/top_right,/area)
"aQ" = (/turf/inn/floor,/turf/inn/rail/middle,/turf/village/roof_delphinia/left_6{layer = 3},/area)
"aR" = (/turf/village/wall_vdalion/bottom_left,/turf/village/roof_delphinia/left_1,/area)
"aS" = (/turf/village/wall_vdalion/bottom,/turf/village/vdalion_extra/windowbig_4,/turf/village/roof_delphinia/left_4,/area)
"aT" = (/turf/village/wall_delphinia/top_left{icon_state = "leg_left"},/area)
"aU" = (/turf/village/wall_delphinia/top_left{icon_state = "leg"},/area)
"aV" = (/turf/village/wall_vdalion/bottom,/turf/village/vdalion_extra/windowbig_4,/turf/village/roof_delphinia/right_4,/area)
"aW" = (/turf/village/wall_vdalion/bottom_right,/turf/village/roof_delphinia/right_1,/area)
"aX" = (/turf/shop_int/stairs/left,/area)
"aY" = (/turf/village/wall_delphinia/top_left{icon_state = "leg"},/turf/village/roof_delphinia/left_7,/area)
"aZ" = (/turf/shop_int/stairs/middle,/area)
"ba" = (/turf/shop_int/stairs/right,/area)
"bb" = (/turf/village/wall_vdalion/bottom_left,/turf/village/roof_delphinia/left_4,/area)
"bc" = (/obj/map/noDenseMarker,/turf/village/roof_delphinia/right_7,/area)
"bd" = (/turf/village/wall_vdalion/bottom,/turf/village/vdalion_extra/windowbig_3,/area)
"be" = (/turf/village/wall_vdalion/bottom_right,/turf/village/roof_delphinia/right_4,/area)
"bf" = (/turf/city/wall/blue{icon_state = "Left"},/turf/shop_int/stairs/bottom_left,/area)
"bg" = (/turf/shop_int/stairs/bottom,/area)
"bh" = (/turf/city/wall/blue{density = 0; icon_state = "Right"},/turf/shop_int/stairs/bottom_right,/area)
"bi" = (/turf/village/wall_vdalion/foundation_middle,/area)
"bj" = (/turf/village/wall_vdalion/foundation_right,/area)
"bk" = (/turf/inn/floor,/turf/inn/rail/bottom_left,/area)
"bm" = (/SmallPreview/Start,/turf,/area)

(1,1,1) = {"
aaaaaaaaaaaaaaaaaaaaaaaaaaaaaaaaae
aaaaababacadadadadadadapabababaCaa
aaaaababafagagagagagahaiajabababaa
aaaaababafagagagagahakaialajababaa
aaaaamanaoagagagahakakaialalajabaa
aaaaaqarasatauawakakakaialalalavaa
aaaaaqararaxayazakakakaBalalalaAaa
aaaaaqararaDaDaEakakaFaGaHalalaAaa
aaaaaqararararaIakaFaJaKaLaHalaAaa
aaaabkaMaNaOaPaQaRaSaKaKaKaVaWaAaa
aaaaaTaUaXaZbaaYbbbdaKaKaKbdbebcaa
aaaabmabbfbgbhabaxbibibibibibjabaa
aaaaaaaaaaaaaaaaaaaaaaaaaaaaaaaaaa
"}
