"aa" = (/turf/void,/area)
"ab" = (/turf,/area)
"ac" = (/obj/map/noDenseMarker,/turf/village/roof_delphinia/center_3,/area)
"ad" = (/obj/map/noDenseMarker,/turf/village/roof_delphinia/left_3,/area)
"ae" = (/turf/village/roof_delphinia/center_2,/area)
"af" = (/obj/map/noDenseMarker,/turf/village/roof_delphinia/center_2,/area)
"ag" = (/turf/village/roof_delphinia/left_2,/area)
"ah" = (/turf/village/roof_delphinia/right_2,/area)
"ai" = (/obj/map/noDenseMarker,/turf/village/roof_delphinia/left_5{layer = 7},/area)
"aj" = (/turf/village/wall_vdalion/bottom,/turf/village/roof_delphinia/center_1,/area)
"ak" = (/obj/map/noDenseMarker,/turf/village/roof_delphinia/right_5,/area)
"al" = (/obj/map/noDenseMarker,/turf/village/roof_delphinia/left_6{layer = 3},/area)
"am" = (/turf/village/wall_vdalion/bottom,/turf/village/roof_delphinia/left_1,/area)
"an" = (/turf/village/wall_vdalion/bottom,/turf/village/roof_delphinia/left_4,/turf/village/roof_delphinia/right_4,/area)
"ao" = (/turf/village/wall_vdalion/bottom,/turf/village/roof_delphinia/right_1,/area)
"ap" = (/obj/map/noDenseMarker,/turf/village/roof_delphinia/right_6,/area)
"aq" = (/turf/inn/rail/middle,/turf/inn/rail/left,/turf/village/roof_delphinia/left_6{layer = 3},/area)
"ar" = (/turf/village/wall_vdalion/bottom,/turf/village/roof_delphinia/left_4,/area)
"as" = (/turf/village/wall_vdalion/bottom,/area)
"at" = (/turf/village/wall_vdalion/bottom,/turf/village/roof_delphinia/right_4,/area)
"au" = (/turf/inn/rail/middle,/turf/inn/rail/right,/turf/village/roof_delphinia/right_6,/area)
"av" = (/turf/inn/floor,/turf/inn/rail/left,/turf/village/roof_delphinia/left_6{layer = 3},/area)
"aw" = (/turf/village/wall_vdalion/bottom_left,/turf/village/roof_delphinia/left_1,/area)
"ax" = (/turf/village/wall_vdalion/bottom,/turf/village/vdalion_extra/windowbig_4,/turf/village/roof_delphinia/left_4,/area)
"ay" = (/turf/village/wall_vdalion/bottom,/turf/village/vdalion_extra/windowbig_4,/turf/village/roof_delphinia/right_4,/area)
"az" = (/turf/village/wall_vdalion/bottom_right,/turf/village/roof_delphinia/right_1,/area)
"aA" = (/turf/inn/floor,/turf/inn/rail/right,/turf/village/roof_delphinia/right_6,/area)
"aB" = (/turf/inn/floor,/turf/inn/rail/left,/turf/village/roof_delphinia/left_7,/area)
"aC" = (/turf/village/wall_vdalion/bottom_left,/turf/village/roof_delphinia/left_4,/area)
"aD" = (/turf/village/wall_vdalion/bottom,/turf/village/vdalion_extra/windowbig_3,/area)
"aE" = (/obj/map/noDenseMarker,/turf/village/roof_delphinia/right_3,/area)
"aF" = (/turf/village/wall_vdalion/bottom,/BuildingDetails{building_category = "Delphina"; building_cost = 25000; building_desc = "A building with 2 rooms."; building_guild = "Delphina"; building_name = "D-Small House E"; building_settlement_only = 1},/turf/village/vdalion_extra/door_top,/area)
"aG" = (/turf/village/wall_vdalion/bottom_right,/turf/village/roof_delphinia/right_4,/area)
"aH" = (/turf/inn/floor,/turf/inn/rail/right,/turf/village/roof_delphinia/right_7,/area)
"aI" = (/turf/inn/floor,/turf/inn/rail/left,/area)
"aJ" = (/turf/village/wall_vdalion/foundation_left,/area)
"aK" = (/turf/village/wall_vdalion/foundation_middle,/area)
"aL" = (/Building/Warper/Exterior,/turf/village/vdalion_extra/door_bottom,/area)
"aM" = (/turf/village/wall_vdalion/foundation_right,/area)
"aN" = (/turf/inn/floor,/turf/inn/rail/right,/area)
"aO" = (/obj/generic_shadow/white{alpha = 75; color = "black"; icon_state = "top"},/turf/inn/floor,/area)
"aP" = (/turf/inn/floor,/turf/inn/rail/middle,/area)
"aQ" = (/turf/inn/floor,/turf/shop_int/stairs/top_left,/area)
"aR" = (/turf/inn/floor,/turf/shop_int/stairs/top,/area)
"aS" = (/turf/inn/floor,/turf/shop_int/stairs/top_right,/area)
"aT" = (/turf/inn/floor,/turf/inn/rail/bottom_left,/area)
"aU" = (/turf/village/wall_delphinia/top_left{icon_state = "leg_left"},/area)
"aV" = (/turf/village/wall_delphinia/top_left{icon_state = "leg"},/area)
"aW" = (/turf/shop_int/stairs/left,/area)
"aX" = (/turf/shop_int/stairs/middle,/area)
"aY" = (/turf/shop_int/stairs/right,/area)
"aZ" = (/turf/village/wall_delphinia/top_fill{icon_state = "leg_right"},/area)
"ba" = (/turf/city/wall/blue{icon_state = "Left"},/turf/shop_int/stairs/bottom_left,/area)
"bb" = (/turf/shop_int/stairs/bottom,/area)
"bc" = (/turf/city/wall/blue{density = 0; icon_state = "Right"},/turf/shop_int/stairs/bottom_right,/area)
"bd" = (/MapLimit,/turf/void,/area)
"be" = (/SmallPreview/End,/turf,/area)
"bf" = (/turf/inn/floor,/turf/inn/rail/bottom_right,/area)
"bg" = (/SmallPreview/Start,/turf,/area)

(1,1,1) = {"
aaaaaaaaaaaaaaaaaaaaaaaaaaaaaaaabd
aaaaaaaaababababacabababbeaaaaaaaa
aaaaaaaaabababadafaEabababaaaaaaaa
aaaaaaaaababadagaeahaEababaaaaaaaa
aaaaaaaaabadagagaeahahaEabaaaaaaaa
aaaaaaaaaiagagagajahahahakaaaaaaaa
aaaaaaaaalagagamanaoahahapaaaaaaaa
aaaaaaaaaqagamarasataoahauaaaaaaaa
aaaaaaaaavawaxasasasayazaAaaaaaaaa
aaaaaaaaaBaCaDasaFasaDaGaHaaaaaaaa
aaaaaaaaaIaJaKaKaLaKaKaMaNaaaaaaaa
aaaaaaaaaIaOaOaOaOaOaOaOaNaaaaaaaa
aaaaaaaaaTaPaPaQaRaSaPaPbfaaaaaaaa
aaaaaaaaaUaVaVaWaXaYaVaVaZaaaaaaaa
aaaaaaaabgababbabbbcabababaaaaaaaa
"}
