"aa" = (/turf,/area)
"ab" = (/obj/map/noDenseMarker,/turf/village/roof_aphros/center_3,/area)
"ac" = (/SmallPreview/End,/MapLimit,/turf,/area)
"ad" = (/obj/map/noDenseMarker,/turf/village/roof_aphros/left_3,/area)
"ae" = (/obj/map/noDenseMarker,/turf/village/roof_aphros/center_2,/area)
"af" = (/obj/map/noDenseMarker,/turf/village/roof_aphros/right_3,/area)
"ag" = (/turf/village/roof_aphros/left_2,/area)
"ah" = (/turf/village/roof_aphros/center_2,/area)
"ai" = (/turf/village/roof_aphros/right_2,/area)
"aj" = (/obj/map/noDenseMarker,/turf/village/horizontal_roof_aphros/top_left,/area)
"ak" = (/turf/village/roof_aphros/left_3,/obj/map/noDenseMarker,/turf/village/horizontal_roof_aphros/top_fill,/area)
"al" = (/turf/village/roof_aphros/left_2,/turf/village/horizontal_roof_aphros/top_fill,/area)
"am" = (/turf/village/roof_aphros/center_2,/turf/village/horizontal_roof_aphros/top_middle,/turf/village/roof_aphros/center_3{layer = 7},/area)
"an" = (/turf/village/roof_aphros/right_2,/turf/village/horizontal_roof_aphros/top_fill,/area)
"ao" = (/turf/village/roof_aphros/right_3,/obj/map/noDenseMarker,/turf/village/horizontal_roof_aphros/top_fill,/area)
"ap" = (/obj/map/noDenseMarker,/turf/village/horizontal_roof_aphros/top_right,/area)
"aq" = (/turf/village/horizontal_roof_aphros/top_left,/obj/map/noDenseMarker,/turf/village/roof_aphros/center_3{layer = 7},/area)
"ar" = (/obj/map/noDenseMarker,/turf/village/horizontal_roof_aphros/top_fill,/area)
"as" = (/turf/village/roof_aphros/left_3,/obj/map/noDenseMarker,/turf/village/horizontal_roof_aphros/left,/area)
"at" = (/turf/village/horizontal_roof_aphros/fill,/area)
"au" = (/turf/village/horizontal_roof_aphros/fill,/turf/village/roof_aphros/left_3{layer = 7},/area)
"av" = (/turf/village/horizontal_roof_aphros/fill,/turf/village/roof_aphros/right_3{layer = 7},/area)
"aw" = (/turf/village/roof_aphros/right_3,/obj/map/noDenseMarker,/turf/village/horizontal_roof_aphros/right,/area)
"ax" = (/turf/village/horizontal_roof_aphros/top_right,/obj/map/noDenseMarker,/turf/village/roof_aphros/center_3{layer = 7},/area)
"ay" = (/obj/map/noDenseMarker,/turf/village/horizontal_roof_aphros/right,/area)
"az" = (/obj/map/noDenseMarker,/turf/village/roof_aphros/left_5,/area)
"aA" = (/turf/village/roof_aphros/left_2,/turf/village/horizontal_roof_aphros/left,/area)
"aB" = (/turf/village/roof_aphros/right_2,/turf/village/horizontal_roof_aphros/right,/area)
"aC" = (/obj/map/noDenseMarker,/turf/village/roof_aphros/right_5,/area)
"aD" = (/obj/map/noDenseMarker,/turf/village/horizontal_roof_aphros/left,/area)
"aE" = (/obj/map/noDenseMarker,/turf/village/roof_aphros/left_6{layer = 7},/area)
"aF" = (/turf/village/roof_aphros/left_2,/turf/village/horizontal_roof_aphros/bottom_left,/area)
"aG" = (/turf/village/wall_aphros/middle_left,/turf/village/horizontal_roof_aphros/bottom_fill,/turf/village/roof_aphros/left_3,/area)
"aH" = (/turf/village/wall_aphros/middle,/turf/village/roof_aphros/center_1,/area)
"aI" = (/turf/village/wall_aphros/middle_right,/turf/village/horizontal_roof_aphros/bottom_fill,/turf/village/roof_aphros/right_3,/area)
"aJ" = (/turf/village/roof_aphros/right_2,/turf/village/horizontal_roof_aphros/bottom_right,/area)
"aK" = (/obj/map/noDenseMarker,/turf/village/roof_aphros/right_6{layer = 3},/area)
"aL" = (/turf/village/wall_aphros/middle_right,/turf/village/horizontal_roof_aphros/bottom_fill,/obj/generic_shadow/white{alpha = 50; color = "black"; icon_state = "full"},/turf/village/roof_aphros/right_5{density = 0; layer = 7},/area)
"aM" = (/turf/ColiseumSilver/ColiseumSilver/front/three,/turf/city/railing/bottom,/turf/village/horizontal_roof_aphros/bottom_right,/area)
"aN" = (/turf/ColiseumSilver/ColiseumSilver/front/three,/turf/city/railing/bottom,/area)
"aO" = (/turf/ColiseumSilver/ColiseumSilver/front/three,/turf/city/railing/bottom,/turf/village/roof_aphros/left_6{layer = 7},/area)
"aP" = (/turf/village/wall_aphros/middle,/turf/village/roof_aphros/left_1,/area)
"aQ" = (/turf/village/wall_aphros/middle,/turf/village/roof_aphros/right_4,/BuildingDetails{building_category = "Aphros"; building_cost = "150,000"; building_desc = "A large fort."; building_guild = "Aphros"; building_interior = 0; building_name = "A-Fort"; building_settlement_only = 1},/turf/village/roof_aphros/left_4,/area)
"aR" = (/turf/village/wall_aphros/middle,/turf/village/roof_aphros/right_1,/area)
"aS" = (/turf/ColiseumSilver/ColiseumSilver/front/three,/turf/city/railing/bottom,/obj/generic_shadow/white{alpha = 25; color = "black"; icon_state = "bl_corner"},/turf/village/roof_aphros/right_6{layer = 3},/area)
"aT" = (/turf/ColiseumSilver/ColiseumSilver/front/three,/turf/city/railing/bottom,/turf/village/horizontal_roof_aphros/bottom_left,/area)
"aU" = (/turf/village/wall_aphros/middle_left,/turf/village/horizontal_roof_aphros/bottom_fill,/turf/village/roof_aphros/left_5{density = 0; layer = 7},/area)
"aV" = (/obj/map/noDenseMarker,/turf/village/roof_aphros/right_5{density = 0; layer = 7},/area)
"aW" = (/turf/village/wall_aphros/middle,/turf/village/roof_aphros/right_4,/turf/village/roof_aphros/left_4,/area)
"aX" = (/turf/village/wall_aphros/bottom_right,/obj/generic_shadow/white{alpha = 50; color = "black"; icon_state = "full"},/turf/village/roof_aphros/right_6{layer = 3},/Region{desc = "Osrona's merchant district, Caelfall has a high number of shops and large homes for those more well off than the majority of the population. Within the middle is a large park with a small body of water within it's center. The jail, as well as the City Watch's headquarters is also known to be found here."; name = "Caelfall"})
"aY" = (/obj/generic_shadow/white{alpha = 75; color = "black"; icon_state = "top"},/turf/gothic/dungeon/floor,/area)
"aZ" = (/turf/gothic/dungeon/floor,/obj/generic_shadow/white{alpha = 75; color = "black"; icon_state = "top"},/turf/village/roof_aphros/left_6{layer = 7},/area)
"ba" = (/turf/village/wall_aphros/middle,/turf/village/roof_aphros/left_4,/area)
"bb" = (/turf/village/wall_aphros/middle,/turf/village/aphros_extra/windowbig_2,/area)
"bc" = (/turf/village/wall_aphros/middle,/turf/village/roof_aphros/right_4,/area)
"bd" = (/turf/gothic/dungeon/floor,/obj/generic_shadow/white{alpha = 75; color = "black"; icon_state = "top"},/obj/generic_shadow/white{alpha = 50; color = "black"; icon_state = "full"},/turf/village/roof_aphros/right_6{layer = 3},/area)
"be" = (/obj/generic_shadow/white{alpha = 75; color = "black"; icon_state = "top"},/obj/generic_shadow/white{alpha = 50; color = "black"; icon_state = "full"},/turf/gothic/dungeon/floor,/area)
"bf" = (/turf/village/wall_aphros/bottom_left,/turf/village/roof_aphros/left_6{layer = 7},/area)
"bg" = (/obj/map/noDenseMarker,/turf/village/roof_aphros/left_6,/area)
"bh" = (/turf/village/wall_aphros/middle,/area)
"bi" = (/turf/gothic/dungeon/floor,/turf/ColiseumSilver/ColiseumSilver/front/three,/turf/city/railing/bottom,/obj/generic_shadow/white{alpha = 50; color = "black"; icon_state = "full"},/turf/village/roof_aphros/right_6{layer = 3},/area)
"bj" = (/turf/gothic/dungeon/floor,/turf/ColiseumSilver/ColiseumSilver/front/three,/turf/city/railing/bottom,/area)
"bk" = (/turf/gothic/dungeon/floor,/turf/ColiseumSilver/ColiseumSilver/front/three,/turf/city/railing/bottom,/turf/village/roof_aphros/left_6{layer = 7},/area)
"bl" = (/turf/village/wall_aphros/middle,/turf/village/aphros_extra/windowbig_1,/turf/house/wooden_window{density = 1; icon_state = "foilage2_top"; layer = 9},/area)
"bm" = (/turf/gothic/dungeon/floor,/turf/ColiseumSilver/ColiseumSilver/front/three,/obj/generic_shadow/white{alpha = 50; color = "black"; icon_state = "full"},/turf/city/railing/bottom,/area)
"bn" = (/obj/map/noDenseMarker,/turf/village/roof_aphros/left_7,/area)
"bo" = (/turf/village/wall_aphros/middle_left,/turf/village/roof_aphros/left_4,/area)
"bp" = (/turf/village/wall_aphros/middle,/turf/village/aphros_extra/window_2,/turf/house/wooden_window{density = 1; icon_state = "foilage2_top"; layer = 9},/area)
"bq" = (/turf/village/wall_aphros/middle_right,/turf/village/roof_aphros/right_4,/area)
"br" = (/turf/ColiseumSilver/ColiseumSilver/front/two,/obj/generic_shadow/white{alpha = 50; color = "black"; icon_state = "full"},/turf/village/roof_aphros/right_7{layer = 7},/area)
"bs" = (/turf/ColiseumSilver/ColiseumSilver/front/two,/area)
"bt" = (/turf/ColiseumSilver/ColiseumSilver/front/two,/turf/village/roof_aphros/left_6{layer = 7},/area)
"bu" = (/turf/village/wall_aphros/middle,/turf/house/wooden_window{density = 1; icon_state = "foilage2_bottom"; layer = 4},/area)
"bv" = (/turf/ColiseumSilver/ColiseumSilver/front/two,/obj/generic_shadow/white{alpha = 50; color = "black"; icon_state = "full"},/turf/village/roof_aphros/right_6{layer = 3},/area)
"bw" = (/obj/generic_shadow/white{alpha = 50; color = "black"; icon_state = "full"},/turf/ColiseumSilver/ColiseumSilver/front/two,/area)
"bx" = (/turf/ColiseumSilver/ColiseumSilver/front/two,/turf/village/roof_aphros/left_7,/area)
"by" = (/obj/map/noDenseMarker,/turf/village/roof_aphros/right_7{layer = 7},/area)
"bz" = (/turf/village/wall_aphros/middle_left,/area)
"bA" = (/turf/village/wall_aphros/middle_right,/area)
"bB" = (/obj/generic_shadow/white{alpha = 50; color = "black"; icon_state = "full"},/turf/village/wall_aphros/middle,/area)
"bC" = (/turf/village/wall_aphros/middle,/turf/city/railing/left,/turf/village/roof_aphros/left_7,/area)
"bD" = (/turf/village/wall_aphros/middle,/turf/city/railing/right{layer = 5},/obj/generic_shadow/white{alpha = 50; color = "black"; icon_state = "full"},/turf/village/roof_aphros/right_7{layer = 7},/area)
"bE" = (/turf/village/wall_aphros/middle,/obj/map/gehenna_castle/Brazier{pixel_x = -1; pixel_y = 24},/turf/ColiseumSilver/ColumnSilver/middle/three,/area)
"bF" = (/turf/gothic/dungeon/floor,/turf/city/railing/left,/area)
"bG" = (/turf/village/wall_aphros/bottom_left,/area)
"bH" = (/turf/village/wall_aphros/bottom,/Region{desc = "Osrona's merchant district, Caelfall has a high number of shops and large homes for those more well off than the majority of the population. Within the middle is a large park with a small body of water within it's center. The jail, as well as the City Watch's headquarters is also known to be found here."; name = "Caelfall"})
"bI" = (/obj/ColiseumSilver/GateSilver/black/gate,/turf/village/wall_aphros/bottom,/Region{desc = "Osrona's merchant district, Caelfall has a high number of shops and large homes for those more well off than the majority of the population. Within the middle is a large park with a small body of water within it's center. The jail, as well as the City Watch's headquarters is also known to be found here."; name = "Caelfall"})
"bJ" = (/Building/Warper/Exterior,/turf/village/wall_aphros/bottom,/Region{desc = "Osrona's merchant district, Caelfall has a high number of shops and large homes for those more well off than the majority of the population. Within the middle is a large park with a small body of water within it's center. The jail, as well as the City Watch's headquarters is also known to be found here."; name = "Caelfall"})
"bK" = (/turf/village/wall_aphros/bottom_right,/Region{desc = "Osrona's merchant district, Caelfall has a high number of shops and large homes for those more well off than the majority of the population. Within the middle is a large park with a small body of water within it's center. The jail, as well as the City Watch's headquarters is also known to be found here."; name = "Caelfall"})
"bL" = (/turf/gothic/dungeon/floor,/obj/generic_shadow/white{alpha = 50; color = "black"; icon_state = "tl_corner"},/turf/city/railing/right{layer = 5},/area)
"bM" = (/obj/generic_shadow/white{alpha = 50; color = "black"; icon_state = "full"},/turf/village/wall_aphros/bottom,/Region{desc = "Osrona's merchant district, Caelfall has a high number of shops and large homes for those more well off than the majority of the population. Within the middle is a large park with a small body of water within it's center. The jail, as well as the City Watch's headquarters is also known to be found here."; name = "Caelfall"})
"bN" = (/turf/village/wall_aphros/bottom,/turf/ColiseumSilver/ColumnSilver/middle/one,/Region{desc = "Osrona's merchant district, Caelfall has a high number of shops and large homes for those more well off than the majority of the population. Within the middle is a large park with a small body of water within it's center. The jail, as well as the City Watch's headquarters is also known to be found here."; name = "Caelfall"})
"bO" = (/obj/generic_shadow/white{alpha = 75; color = "black"; icon_state = "top"},/obj/map/village/statue/mage/right{pixel_y = 10},/turf/gothic/dungeon/floor,/area)
"bP" = (/obj/generic_shadow/white{alpha = 75; color = "black"; icon_state = "top"},/obj/map/village/statue/mage/left{pixel_y = 10},/turf/gothic/dungeon/floor,/area)
"bQ" = (/turf/gothic/dungeon/floor,/turf/city/railing/right{layer = 5},/area)
"bR" = (/SmallPreview/Start,/turf/village/wall_aphros/bottom_left,/area)
"bS" = (/obj/generic_shadow/white{alpha = 50; color = "black"; icon_state = "tl_corner"},/turf,/area)
"bT" = (/turf/ColiseumSilver/ColumnSilver/bottom,/area)
"bU" = (/turf/gothic/dungeon/floor,/area)
"bV" = (/obj/generic_shadow/white{alpha = 50; color = "black"; icon_state = "full"},/turf,/area)
"bW" = (/turf/void,/area)
"bX" = (/turf/academy/fence/side/left,/area)
"bY" = (/turf/gothic/dungeon/floor,/turf/ColiseumSilver/ColiseumSilver/front/three,/turf/ColiseumSilver/ColiseumSilver/right/nineteen,/turf/city/railing/bottom/left,/area)
"bZ" = (/turf/gothic/dungeon/floor,/turf/city/railing/top/right/one,/area)
"ca" = (/turf/gothic/dungeon/floor,/turf/city/railing/top/left/one,/area)
"cb" = (/turf/gothic/dungeon/floor,/turf/ColiseumSilver/ColiseumSilver/front/three,/turf/ColiseumSilver/ColiseumSilver/right/sixty,/turf/city/railing/bottom/right,/area)
"cc" = (/turf/academy/fence/side/right,/area)
"cd" = (/turf/ColiseumSilver/ColiseumSilver/front/two,/turf/ColiseumSilver/ColiseumSilver/right/fortysix,/area)
"ce" = (/turf/city/stairs,/turf/city/railing/left,/area)
"cf" = (/turf/city/stairs,/area)
"cg" = (/turf/city/stairs,/turf/city/railing/right{layer = 5},/area)
"ch" = (/turf/ColiseumSilver/ColiseumSilver/front/two,/turf/ColiseumSilver/ColiseumSilver/left/fifty,/area)
"ci" = (/turf/village/wall_aphros/bottom,/turf/ColiseumSilver/ColiseumSilver/right/fortysix,/Region{desc = "Osrona's merchant district, Caelfall has a high number of shops and large homes for those more well off than the majority of the population. Within the middle is a large park with a small body of water within it's center. The jail, as well as the City Watch's headquarters is also known to be found here."; name = "Caelfall"})
"cj" = (/turf/village/wall_aphros/bottom,/turf/ColiseumSilver/ColiseumSilver/left/fifty,/Region{desc = "Osrona's merchant district, Caelfall has a high number of shops and large homes for those more well off than the majority of the population. Within the middle is a large park with a small body of water within it's center. The jail, as well as the City Watch's headquarters is also known to be found here."; name = "Caelfall"})
"ck" = (/turf/city/stairs/bottom,/turf/city/railing/left,/area)
"cl" = (/turf/city/stairs/bottom,/area)
"cm" = (/turf/city/stairs/bottom,/turf/city/railing/right{layer = 5},/area)
"cn" = (/turf/academy/fence/horizontal/bottom/left,/area)
"co" = (/turf/academy/fence/horizontal/bottom/middle,/area)
"cp" = (/turf/academy/fence/post/left,/area)
"cq" = (/turf/academy/fence/post/right,/area)
"cr" = (/turf/academy/fence/horizontal/bottom/right,/area)

(1,1,1) = {"
aaaaaaaaaaaaaaaaaaaaaaaaaaaaabaaaaaaaaaaaaaaaaaaaaaaaaaaac
aaaaaaaaaaaaaaaaaaaaaaaaaaadaeafaaaaaaaaaaaaaaaaaaaaaaaaaa
aaaaaaaaaaaaaaaaaaaaaaaaadagahaiafaaaaaaaaaaaaaaaaaaaaaaaa
aaaaaaaaaaaaaaaaaaaaajakalalamananaoapaaaaaaaaaaaaaaaaaaaa
aaaaaaaqarararapaaaaasatatauahavatatawaaaaajarararaxaaaaaa
aaaaadahavatatayaaazaAatauagahaiavataBaCaaaDatatauahafaaaa
aaadagahaiavatayaaaEaFaGagagaHaiaiaIaJaKaaaDatauagahaiafaa
azagagaHaiaiaLaMaNaOagagagaPaQaRaiaiaiaSaNaTaUagagaHaiaiaV
aEagaPaWaRaiaXaYaYaZagagaPbabbbcaRaiaibdbeaYbfagaPaWaRaiaK
bgaPbabhbcaRbibjbjbkagaPbabhblbhbcaRaibibmbjbkaPbabhbcaRaK
bnbobhbpbhbqbrbsbsbtaPbabhbhbubhbhbcaRbvbwbsbxbobhbpbhbqby
aabzbhbubhbAbBbhbhbCbobhbhbhbhbhbhbhbqbDbBbhbhbzbhbubhbAaa
aabzbhbpbhbAbBbEbhbFbGbHbHbIbJbHbHbHbKbLbBbEbhbzbhbpbhbAaa
aabzbhbubhbAbMbNbHbFaYaYbOaYaYaYbPaYaYbQbMbNbHbzbhbubhbAaa
aabRbHbHbHbKbSbTaabFbUbUbUbUbUbUbUbUbUbQbVbTaabGbHbHbHbKaa
bWbWbWbXaaaaaaaaaabYbjbZbUbUbUbUbUcabjcbbVaaaaaaaaccbWbWbW
bWbWbWbXaaaaaaaaaacdbscecfcfcfcfcfcgbschbVaaaaaaaaccbWbWbW
bWbWbWbXaaaaaaaaaacibHcecfcfcfcfcfcgbHcjbSaaaaaaaaccbWbWbW
bWbWbWbXaaaaaaaaaaaaaackclclclclclcmaaaaaaaaaaaaaaccbWbWbW
bWbWbWbXaaaaaaaaaaaaaaaaaaaaaaaaaaaaaaaaaaaaaaaaaaccbWbWbW
bWbWbWbXaaaaaaaaaaaaaaaaaaaaaaaaaaaaaaaaaaaaaaaaaaccbWbWbW
bWbWbWcncococococococpaaaaaaaaaaaaaacqcococococococrbWbWbW
bWbWbWbWbWbWbWbWbWbWbWbWbWbWbWbWbWbWbWbWbWbWbWbWbWbWbWbWbW
"}
