"aa" = (/turf/void,/area)
"ab" = (/MapLimit,/turf/void,/area)
"ac" = (/obj/map/viewBlock,/turf/void,/area)
"ad" = (/turf/castle_int/roof/corner/br,/area)
"ae" = (/turf/castle_int/roof/bottom,/area)
"af" = (/turf/castle_int/roof/corner/bl,/area)
"ag" = (/turf/castle_int/roof/right,/area)
"ah" = (/turf/village/wall_aphros/middle,/obj/generic_shadow/white{alpha = 50; color = "black"; icon_state = "full"; layer = 4},/turf/jianghu_house/shadow{density = 1},/area)
"ai" = (/turf/village/wall_aphros/middle,/turf/jianghu_house/shadow{density = 1},/area)
"aj" = (/turf/village/wall_aphros/middle,/turf/jianghu_house/shadow{density = 1},/turf/village/aphros_extra/windowbig_2,/area)
"ak" = (/turf/castle_int/roof/left,/area)
"al" = (/obj/generic_shadow/white{alpha = 50; color = "black"; icon_state = "full"; layer = 4},/turf/village/wall_aphros/middle,/area)
"am" = (/turf/village/wall_aphros/middle,/area)
"an" = (/turf/village/wall_aphros/middle,/obj/map/cave_light,/turf/village/aphros_extra/windowbig_1,/area)
"ao" = (/obj/generic_shadow/white{alpha = 50; color = "black"; icon_state = "full"; layer = 4},/turf/village/wall_aphros/bottom,/Region{desc = "Osrona's merchant district, Caelfall has a high number of shops and large homes for those more well off than the majority of the population. Within the middle is a large park with a small body of water within it's center. The jail, as well as the City Watch's headquarters is also known to be found here."; name = "Caelfall"})
"ap" = (/turf/village/wall_aphros/bottom,/Region{desc = "Osrona's merchant district, Caelfall has a high number of shops and large homes for those more well off than the majority of the population. Within the middle is a large park with a small body of water within it's center. The jail, as well as the City Watch's headquarters is also known to be found here."; name = "Caelfall"})
"aq" = (/obj/generic_shadow/white{alpha = 50; color = "black"; icon_state = "full"; layer = 4},/obj/generic_shadow/white{alpha = 75; color = "black"; icon_state = "top"},/turf/castle_int/floor,/area)
"ar" = (/obj/generic_shadow/white{alpha = 75; color = "black"; icon_state = "top"},/turf/castle_int/floor,/area)
"as" = (/obj/generic_shadow/white{alpha = 50; color = "black"; icon_state = "full"; layer = 4},/turf/castle_int/floor,/area)
"at" = (/turf/castle_int/floor,/area)
"au" = (/turf,/area)
"av" = (/turf/castle_int/roof/bottom_right,/area)
"aw" = (/turf/castle_int/roof/bottom_left,/area)
"ax" = (/turf/village/wall_aphros/middle_right,/obj/generic_shadow/white{alpha = 50; color = "black"; icon_state = "full"; layer = 4},/turf/jianghu_house/shadow{density = 1},/area)
"ay" = (/turf/village/wall_aphros/middle,/turf/village/aphros_extra/windowbig_1,/area)
"az" = (/turf/village/wall_aphros/middle_left,/turf/jianghu_house/shadow{density = 1},/area)
"aA" = (/obj/generic_shadow/white{alpha = 50; color = "black"; icon_state = "full"; layer = 4},/turf/village/wall_aphros/middle_right,/area)
"aB" = (/turf/village/wall_aphros/middle_left,/area)
"aC" = (/obj/generic_shadow/white{alpha = 50; color = "black"; icon_state = "full"; layer = 4},/turf/village/wall_aphros/bottom_right,/Region{desc = "Osrona's merchant district, Caelfall has a high number of shops and large homes for those more well off than the majority of the population. Within the middle is a large park with a small body of water within it's center. The jail, as well as the City Watch's headquarters is also known to be found here."; name = "Caelfall"})
"aD" = (/obj/generic_shadow/white{alpha = 50; color = "black"; icon_state = "tl_corner"},/obj/generic_shadow/white{alpha = 75; color = "black"; icon_state = "top"},/turf/castle_int/floor,/area)
"aE" = (/turf/village/wall_aphros/bottom_left,/area)
"aF" = (/turf/castle_int/roof/corner/tr,/area)
"aG" = (/turf/castle_int/roof/top,/area)
"aH" = (/obj/map/DenseMarker,/turf/castle_int/roof/top_right,/area)
"aI" = (/Building/Warper/Dynamic{dynamic_id = "aphros_fort_room2"},/turf/castle_int/floor,/area)
"aJ" = (/obj/map/DenseMarker,/turf/castle_int/roof/top_left,/area)
"aK" = (/turf/castle_int/roof/corner/tl,/area)
"aL" = (/Building/Warper/Dynamic{dynamic_id = "aphros_fort_room3"},/turf/castle_int/floor,/area)
"aM" = (/obj/map/DenseMarker,/turf/castle_int/roof/corner/tr,/area)
"aN" = (/obj/map/cave_light,/obj/map/DenseMarker,/turf/castle_int/roof/top,/area)
"aO" = (/obj/map/DenseMarker,/turf/castle_int/roof/corner/tl,/area)
"aP" = (/obj/map/viewBlock,/turf,/area)
"aQ" = (/Building/Warper/Dynamic{dynamic_id = "aphros_fort_room9"},/turf/castle_int/floor,/area)
"aR" = (/turf/village/wall_aphros/middle,/turf/village/aphros_extra/door_top,/area)
"aS" = (/turf/village/wall_aphros/middle_right,/turf/jianghu_house/shadow{density = 1},/area)
"aT" = (/obj/map/DenseMarker,/turf/castle_int/roof/top,/area)
"aU" = (/Building/Warper/Dynamic{dynamic_id = "aphros_fort_room2"},/obj/map/noDenseMarker,/turf/village/aphros_extra/door_bottom,/Region{desc = "Osrona's merchant district, Caelfall has a high number of shops and large homes for those more well off than the majority of the population. Within the middle is a large park with a small body of water within it's center. The jail, as well as the City Watch's headquarters is also known to be found here."; name = "Caelfall"})
"aV" = (/turf/village/wall_aphros/middle_right,/area)
"aW" = (/Building/Warper/Dynamic{dynamic_id = "aphros_fort_room3"},/obj/map/noDenseMarker,/turf/village/aphros_extra/door_bottom,/Region{desc = "Osrona's merchant district, Caelfall has a high number of shops and large homes for those more well off than the majority of the population. Within the middle is a large park with a small body of water within it's center. The jail, as well as the City Watch's headquarters is also known to be found here."; name = "Caelfall"})
"aX" = (/turf/village/wall_aphros/bottom_right,/Region{desc = "Osrona's merchant district, Caelfall has a high number of shops and large homes for those more well off than the majority of the population. Within the middle is a large park with a small body of water within it's center. The jail, as well as the City Watch's headquarters is also known to be found here."; name = "Caelfall"})
"aY" = (/obj/generic_shadow/white{alpha = 75; color = "black"; icon_state = "top"},/Building/Warper/Dynamic{dynamic_id = "aphros_fort_room6"},/turf/castle_int/floor,/area)
"aZ" = (/obj/map/cave_light,/turf/castle_int/roof/left,/area)
"ba" = (/turf/castle_int/roof/top_left,/area)
"bb" = (/obj/map/castle/gate/open,/turf/village/wall_aphros/bottom,/Region{desc = "Osrona's merchant district, Caelfall has a high number of shops and large homes for those more well off than the majority of the population. Within the middle is a large park with a small body of water within it's center. The jail, as well as the City Watch's headquarters is also known to be found here."; name = "Caelfall"})
"bc" = (/Building/Warper/Dynamic{dynamic_id = "aphros_fort_room9"},/obj/map/noDenseMarker,/turf/castle_int/floor,/Region{desc = "Osrona's merchant district, Caelfall has a high number of shops and large homes for those more well off than the majority of the population. Within the middle is a large park with a small body of water within it's center. The jail, as well as the City Watch's headquarters is also known to be found here."; name = "Caelfall"})
"bd" = (/turf/castle_int/roof/top_right,/area)
"be" = (/obj/map/DenseMarker,/turf/gothic/castle_int/stairs/middle,/area)
"bf" = (/Building/Warper/Dynamic{dynamic_id = "aphros_fort_room4"},/turf/gothic/castle_int/stairs/middle,/area)
"bg" = (/Building/Warper/Dynamic{dynamic_id = "aphros_fort_room5"},/turf/gothic/castle_int/stairs/middle,/area)
"bh" = (/obj/map/DenseMarker,/turf/castle_int/roof/bottom,/area)
"bi" = (/obj/map/cave_light,/obj/map/DenseMarker,/turf/castle_int/roof/bottom,/area)
"bj" = (/turf/gothic/castle_int/stairs/middle,/area)
"bk" = (/obj/generic_shadow/white{alpha = 50; color = "black"; icon_state = "tl_corner"},/turf/castle_int/floor,/area)
"bl" = (/obj/generic_shadow/white{alpha = 75; color = "black"; icon_state = "top"},/Building/Warper/Dynamic{dynamic_id = "aphros_fort_room1"},/turf/castle_int/floor,/area)
"bm" = (/obj/map/cave_light,/turf/castle_int/roof/right,/area)
"bn" = (/obj/generic_shadow/white{alpha = 50; color = "black"; icon_state = "full"; layer = 4},/Building/Warper/Dynamic{dynamic_id = "aphros_fort_room1"},/turf/castle_int/floor,/area)
"bo" = (/turf/castle_int/floor,/Region{desc = "Osrona's merchant district, Caelfall has a high number of shops and large homes for those more well off than the majority of the population. Within the middle is a large park with a small body of water within it's center. The jail, as well as the City Watch's headquarters is also known to be found here."; name = "Caelfall"})
"bp" = (/BuildingDetails{building_category = "Aphros"; building_cost = "150000"; building_desc = "A large fort.\""; building_guild = "Aphros"; building_interior = 1; building_name = "A-Fort"; building_settlement_only = 1},/turf/castle_int/floor,/area)
"bq" = (/Building/Warper/Interior,/turf/castle_int/floor,/area)

(1,1,1) = {"
aaaaaaaaaaaaaaaaaaaaaaaaaaaaaaaaaaaaaaaaaaaaaaaaaaaaaaaaaaaaaaaaaaaaaaaaaaaaaaaaaaaaaaaaaaaaaaaaaaaaaaaaaaaaaaaaaaaaaaaaaaaaaaaaaaaaaaaaaaaaaaaaaaaaaaaaaaaaaaaaaaaaaaaaaaaaaaaaaaaaaaaaaaaaaaaaaaaaaaaaab
aaaaaaaaaaaaaaaaaaaaaaaaaaaaaaaaaaaaaaaaaaaaaaaaaaaaaaaaaaaaaaaaaaaaaaaaaaaaaaaaaaaaaaaaaaaaaaaaaaaaaaaaaaaaaaaaaaaaaaaaaaaaaaaaaaaaaaaaaaaaaaaaaaaaaaaaaaaaaaaaaaaaaaaaaaaaaaaaaaaaaaaaaaaaaaaaaaaaaaaaaa
aaaaaaaaaaaaaaaaaaaaaaaaaaaaaaaaaaaaaaaaaaaaaaaaaaaaaaaaaaaaaaaaaaaaaaaaaaaaaaaaaaaaaaaaaaaaaaaaaaaaaaaaaaaaaaaaaaaaaaaaaaaaaaaaaaaaaaaaaaaaaaaaaaaaaaaaaaaaaaaaaaaaaaaaaaaaaaaaaaaaaaaaaaaaaaaaaaaaaaaaaa
aaaaaaaaaaaaaaaaaaaaaaaaaaaaaaaaaaaaaaaaaaaaaaaaaaaaaaaaaaaaaaaaaaaaaaaaaaaaaaaaaaaaaaaaaaaaaaaaaaaaaaaaaaaaaaaaaaaaaaaaaaaaaaaaaaaaaaaaaaaaaaaaaaaaaaaaaaaaaaaaaaaaaaaaaaaaaaaaaaaaaaaaaaaaaaaaaaaaaaaaaa
aaaaaaaaaaaaaaaaaaaaaaaaaaaaaaaaaaaaaaaaaaaaaaaaaaaaaaaaaaaaaaaaaaaaaaaaaaaaaaaaaaaaaaaaaaaaaaaaaaaaaaaaaaaaaaaaaaaaaaaaaaaaaaaaaaaaaaaaaaaaaaaaaaaaaaaaaaaaaaaaaaaaaaaaaaaaaaaaaaaaaaaaaaaaaaaaaaaaaaaaaa
aaaaaaaaaaaaaaaaaaaaaaaaaaaaaaaaaaaaaaaaaaaaaaaaaaaaaaaaaaaaaaaaaaaaaaaaaaaaaaaaaaaaaaaaaaaaaaaaaaaaaaaaaaaaaaaaaaaaaaaaaaaaaaaaaaaaaaaaaaaaaaaaaaaaaaaaaaaaaaaaaaaaaaaaaaaaaaaaaaaaaaaaaaaaaaaaaaaaaaaaaa
aaaaaaaaaaaaaaaaaaaaaaaaaaaaaaaaaaaaaaaaaaaaaaaaaaaaaaaaaaaaaaaaaaaaaaaaaaaaaaaaaaaaaaaaaaaaaaaaaaaaaaaaaaaaaaaaaaaaaaaaaaaaaaaaaaaaaaaaaaaaaaaaaaaaaaaaaaaaaaaaaaaaaaaaaaaaaaaaaaaaaaaaaaaaaaaaaaaaaaaaaa
aaaaaaaaaaaaaaaaaaaaaaaaaaaaaaaaaaaaaaaaaaaaaaaaaaaaaaaaaaaaaaaaaaaaaaaaaaaaaaaaaaaaaaaaaaaaaaaaaaaaaaaaaaaaaaaaaaaaaaaaaaaaaaaaaaaaaaaaaaaaaaaaaaaaaaaaaaaaaaaaaaaaaaaaaaaaaaaaaaaaaaaaaaaaaaaaaaaaaaaaaa
aaaaaaaaaaaaaaaaaaaaaaaaaaaaaaaaaaaaaaaaaaaaaaaaaaaaaaaaaaaaaaaaaaaaaaaaaaaaaaaaaaaaaaaaaaaaaaaaaaaaaaaaaaaaaaaaaaaaaaaaaaaaaaaaaaaaaaaaaaaaaaaaaaaaaaaaaaaaaaaaaaaaaaaaaaaaaaaaaaaaaaaaaaaaaaaaaaaaaaaaaa
aaaaaaaaaaaaaaaaaaaaaaaaaaaaaaaaaaaaaaaaaaaaaaaaaaaaaaaaaaaaaaaaaaaaaaaaaaaaaaaaaaaaaaaaaaaaaaaaaaaaaaaaaaaaaaaaaaaaaaaaaaaaaaaaaaaaaaaaaaaaaaaaaaaaaaaaaaaaaaaaaaaaaaaaaaaaaaaaaaaaaaaaaaaaaaaaaaaaaaaaaa
aaaaaaaaaaaaaaaaaaaaaaaaaaaaaaaaaaaaaaaaaaaaaaaaaaaaaaaaaaaaaaaaaaaaaaaaaaaaaaaaaaaaaaaaaaaaaaaaaaaaaaaaaaaaaaaaaaaaaaaaaaaaaaaaaaaaaaaaaaaaaaaaaaaaaaaaaaaaaaaaaaaaaaaaaaaaaaaaaaaaaaaaaaaaaaaaaaaaaaaaaa
aaaaaaaaaaaaaaaaaaaaaaaaaaaaaaaaaaaaaaaaaaaaaaaaaaaaaaaaaaaaaaaaaaaaaaaaaaaaaaaaaaaaaaaaaaaaaaaaaaaaaaaaaaaaaaaaaaaaaaaaaaaaaaaaaaaaaaaaaaaaaaaaaaaaaaaaaaaaaaaaaaaaaaaaaaaaaaaaaaaaaaaaaaaaaaaaaaaaaaaaaa
aaaaaaaaaaaaaaaaaaaaaaaaaaaaaaaaaaaaaaaaaaaaaaaaaaaaaaaaaaaaaaaaaaaaaaaaaaaaaaaaaaaaaaaaaaaaaaaaaaaaaaaaaaaaaaaaaaaaaaaaaaaaaaaaaaaaaaaaaaaaaaaaaaaaaaaaaaaaaaaaaaaaaaaaaaaaaaaaaaaaaaaaaaaaaaaaaaaaaaaaaa
aaaaaaaaaaaaaaaaaaaaaaaaaaaaaaaaaaaaaaaaaaaaaaaaaaaaaaaaaaaaaaaaaaaaaaaaaaaaaaaaaaaaaaaaaaaaaaaaaaaaaaaaaaaaaaaaaaaaaaaaaaaaaaaaaaaaaaaaaaaaaaaaaaaaaaaaaaaaaaaaaaaaaaaaaaaaaaaaaaaaaaaaaaaaaaaaaaaaaaaaaa
aaaaaaaaaaaaaaaaaaaaaaaaaaaaaaaaaaaaaaaaaaaaaaaaaaaaaaaaaaaaaaaaaaaaaaaaaaaaaaaaaaaaaaaaaaaaaaaaaaaaaaaaaaaaaaaaaaaaaaaaaaaaaaaaaaaaaaaaaaaaaaaaaaaaaaaaaaaaaaaaaaaaaaaaaaaaaaaaaaaaaaaaaaaaaaaaaaaaaaaaaa
aaaaaaaaaaaaaaaaaaaaaaaaaaaaaaaaaaaaaaaaaaaaaaaaaaaaaaaaaaaaaaaaaaaaaaaaaaaaaaaaaaaaaaaaaaaaaaaaaaaaaaaaaaaaaaaaaaaaaaaaaaaaaaaaaaaaaaaaaaaaaaaaaaaaaaaaaaaaaaaaaaaaaaaaaaaaaaaaaaaaaaaaaaaaaaaaaaaaaaaaaa
aaaaaaaaaaaaaaaaaaaaaaaaaaaaaaaaaaaaaaaaaaaaaaaaaaaaaaaaaaaaaaaaaaaaaaaaaaaaaaaaaaaaaaaaaaaaaaaaaaaaaaaaaaaaaaaaaaaaaaaaaaaaaaaaaaaaaaaaaaaaaaaaaaaaaaaaaaaaaaaaaaaaaaaaaaaaaaaaaaaaaaaaaaaaaaaaaaaaaaaaaa
aaaaaaaaaaaaaaaaaaaaaaaaaaaaaaaaaaaaaaaaaaaaaaaaaaaaaaaaaaaaaaaaaaaaaaaaaaaaaaaaaaaaaaaaaaaaaaaaaaaaaaaaaaaaaaaaaaaaaaaaaaaaaaaaaaaaaaaaaaaaaaaaaaaaaaaaaaaaaaaaaaaaaaaaaaaaaaaaaaaaaaaaaaaaaaaaaaaaaaaaaa
aaaaaaaaaaaaaaaaaaaaaaaaaaaaaaaaaaaaaaaaacacacacacacacacacacacacacacacacacacacacacacacacacacacacacaaaaaaaaaaaaaaaaaaaaaaaaaaaaaaaaaaaaaaaaaaaaaaaaaaaaaaaaaaaaaaaaaaaaaaaaaaaaaaaaaaaaaaaaaaaaaaaaaaaaaaaa
aaaaaaaaaaaaaaaaaaaaaaaaaaaaaaaaaaaaaaaaacaaaaaaaaaaaaaaaaaaaaaaaaaaaaaaaaaaaaaaaaaaaaaaaaaaaaaaacaaaaaaaaaaaaaaaaaaaaaaaaaaaaaaaaaaaaaaaaaaaaaaaaaaaaaaaaaaaaaaaaaaaaaaaaaaaaaaaaaaaaaaaaaaaaaaaaaaaaaaaa
aaaaaaaaaaaaaaaaaaaaaaaaaaaaaaaaaaaaaaaaacaaadaeaeaeaeaeaeaeaeaeaeaeaeaeaeaeaeaeaeaeaeaeaeaeafaaacaaaaaaaaaaaaaaaaaaaaaaaaaaaaaaaaaaaaaaaaaaaaaaaaaaaaaaaaaaaaaaaaaaaaaaaaaaaaaaaaaaaaaaaaaaaaaaaaaaaaaaaa
aaaaaaaaaaaaaaaaaaaaaaaaaaaaaaaaaaaaaaaaacaaagahaiajaiaiaiaiaiaiaiaiajaiaiaiaiaiaiaiaiajaiaiakaaacaaaaaaaaaaaaaaaaaaaaaaaaaaaaaaaaaaaaaaaaaaaaaaaaaaaaaaaaaaaaaaaaaaaaaaaaaaaaaaaaaaaaaaaaaaaaaaaaaaaaaaaa
aaaaaaaaaaaaaaaaaaaaaaaaaaaaaaaaaaaaaaaaacaaagalamanamamamamamamamamanamamamamamamamamanamamakaaacaaaaaaaaaaaaaaaaaaaaaaaaaaaaaaaaaaaaaaaaaaaaaaaaaaaaaaaaaaaaaaaaaaaaaaaaaaaaaaaaaaaaaaaaaaaaaaaaaaaaaaaa
aaaaaaaaaaaaaaaaaaaaaaaaaaaaaaaaaaaaaaaaacaaagaoapapapapapapapapapapapapapapapapapapapapapapakaaacaaaaaaaaaaaaaaaaaaaaaaaaaaaaaaaaaaaaaaaaaaaaaaaaaaaaaaaaaaaaaaaaaaaaaaaaaaaaaaaaaaaaaaaaaaaaaaaaaaaaaaaa
aaaaaaaaaaaaaaaaaaaaaaaaaaaaaaaaaaaaaaaaacaaagaqararararararararararararararararararararararakaaacaaaaaaaaaaaaaaaaaaaaaaaaaaaaaaaaaaaaaaaaaaaaaaaaaaaaaaaaaaaaaaaaaaaaaaaaaaaaaaaaaaaaaaaaaaaaaaaaaaaaaaaa
aaaaaaaaaaaaaaaaaaaaaaaaaaaaaaaaaaaaaaaaacaaagasatatatatatatatatatatatatatatatatatatatatatatakaaacaaaaaaaaaaaaaaaaaaaaaaaaaaaaaaaaaaaaaaaaaaaaaaaaaaaaaaaaaaaaaaaaaaaaaaaaaaaaaaaaaaaaaaaaaaaaaaaaaaaaaaaa
acacacacacacacacacacacacacacacacacacacacacaaagasatatatatatatatatatatatatatatatatatatatatatatakaaacaaaaaaaaaaaaaaaaaaaaaaaaaaaaaaaaaaaaaaaaaaaaaaaaaaaaaaaaaaaaaaaaaaaaaaaaaaaaaaaaaaaaaaaaaaaaaaaaaaaaaaaa
acaaaaaaaaaaaaaaaaaaaaaaaaaaaaaaaaaaaaaaacaaagasatatatatatatatatatatatatatatatatatatatatatatakaaacaaaaaaaaaaaaaaaaaaaaaaaaaaaaaaaaaaaaaaaaaaaaaaaaaaaaaaaaaaaaaaaaaaaaaaaaaaaaaaaaaaaaaaaaaaaaaaaaaaaaaaaa
acaaadaeaeaeaeaeaeaeaeaeaeaeaeaeaeaeafaaacaaagasatatatatatatatatatatatatatatatatatatatatatatakaaacaaaaaaaaaaaaaaaaaaaaaaaaaaaaaaaaaaaaaaaaaaaaaaaaaaaaaaaaaaaaaaaaaaaaaaaaaaaaaaaaaaaaaaaaaaaaaaaaaaaaaaaa
acaaagahaiajaiaiaiaiaiaiaiaiaiajaiaiakaaacaaagasatatatatatatatatatatatatatatatatatatatatatatakaaacaaaaaaaaaaaaaaaaaaaaaaaaaaaaaaaaaaaaaaaaaaaaaaaaaaaaaaaaaaaaaaaaaaaaaaaaaaaaaaaaaaaaaaaaaaaaaaaaaaaaaaaa
acaaagalamanamamamamamamamamamanamamakaaacaaagasatatatatatatatatatatatatatatatatatatatatatatakaaacaaaaaaaaaaaaaaaaaaaaaaaaaaaaaaaaaaaaaaaaaaaaaaaaaaaaaaaaaaaaaaaaaaaaaaaaaaaaaaaaaaaaaaaaaaaaaaaaaaaaaaaa
acaaagaoapapapapapapapapapapapapapapakaaacaaagasatatatatatatatatatatatatatatatatatatatatatatakaaacaaaaaaaaaaaaaaaaaaaaaaaaaaaaaaaaaaaaaaaaaaaaaaaaaaaaaaaaaaaaaaaaaaaaaaaaaaaaaaaaaaaaaaaaaaaaaaaaaaaaaaaa
acaaagaqararararararararararararararakaaacaaagasatatatatatatatatatatatatatatatatatatatatatatakaaacaaaaaaaaaaaaaaaaaaaaaaaaaaaaaaaaaaaaaaaaaaaaaaaaaaaaaaaaaaaaaaaaaaaaaaaaaaaaaaaaaaaaaaaaaaaaaaaaaaaaaaaa
acaaagasatatatatatatatatatatatatatatakaaacaaagasatatatatatatatatatatatatatatatatatatatatatatakaaacaaaaaaaaaaaaaaaaaaaaaaaaaaaaaaaaaaaaaaaaaaaaaaaaaaaaaaaaaaaaaaaaaaaaaaaaaaaaaaaaaaaaaaaaaaaaaaaaaaaaaaaa
acaaagasatatatatatatatatatatatatatatakaaacaaagasatatatatatatatatatatatatatatatatatatatatatatakaaacaaaaaaaaaaaaaaaaaaaaacacacacacacacacacacacacacacacacacaaaaaaaaaaaaaaaaaaaaaaaaaaaaaaaaaaaaaaaaaaaaaaaaaa
acaaagasatatatatatatatatatatatatatatakaaacaaagasatatatatatatatatatatatatatatatatatatatatatatakaaacaaaaaaaaaaaaaaaaaaaaacauadaeaeaeaeaeaeaeaeaeaeaeafauacaaaaaaaaaaaaaaaaaaaaaaaaaaaaaaaaaaaaaaaaaaaaaaaaaa
acaaagasatatatatatatatatatatatatatatakaaacaaagasatatatatatatatatatatatatatatatatatatatatatatakaaacaaaaaaaaaaaaaaaaaaaaacadavahaiajaiaiaiaiaiajaiaiawafacaaaaaaaaaaaaaaaaaaaaaaaaaaaaaaaaaaaaaaaaaaaaaaaaaa
acaaagasatatatatatatatatatatatatatatakaaacaaagasatatatatatatatatatatatatatatatatatatatatatatakaaacaaaaaaaaaaaaaaaaaaaaacagaxalamayamamamamamayamamazakacaaaaaaaaaaaaaaaaaaaaaaaaaaaaaaaaaaaaaaaaaaaaaaaaaa
acaaagasatatatatatatatatatatatatatatakaaacaaagasatatatatatatatatatatatatatatatatatatatatatatakaaacaaaaaaaaaaaaaaaaaaaaacagaAaoapapapapapapapapapapaBakacaaaaaaaaaaaaaaaaaaaaaaaaaaaaaaaaaaaaaaaaaaaaaaaaaa
acaaagasatatatatatatatatatatatatatatakaaacaaagasatatatatatatatatatatatatatatatatatatatatatatakaaacaaaaaaaaaaaaaaaaaaaaacagaCaDararararararararararaEakacaaaaaaaaaaaaaaaaaaaaaaaaaaaaaaaaaaaaaaaaaaaaaaaaaa
acaaagasatatatatatatatatatatatatatatakaaacaaagasatatatatatatatatatatatatatatatatatatatatatatakaaacaaaaaaaaaaaaaaaaaaaaacagasatatatatatatatatatatatatakacaaaaaaaaaaaaaaaaaaaaaaaaaaaaaaaaaaaaaaaaaaaaaaaaaa
acaaagasatatatatatatatatatatatatatatakaaacaaagasatatatatatatatatatatatatatatatatatatatatatatakaaacaaaaaaaaaaaaaaaaaaaaacagasatatatatatatatatatatatatakacaaaaaaaaaaaaaaaaaaaaaaaaaaaaaaaaaaaaaaaaaaaaaaaaaa
acaaagasatatatatatatatatatatatatatatakaaacaaagasatatatatatatatatatatatatatatatatatatatatatatakaaacaaaaaaaaaaaaaaaaaaaaacagasatatatatatatatatatatatatakacaaaaaaaaaaaaaaaaaaaaaaaaaaaaaaaaaaaaaaaaaaaaaaaaaa
acaaaFaGaGaGaGaGaGaHaIaJaGaGaGaGaGaGaKaaacaaaFaGaGaGaGaGaGaGaGaGaGaHaLaJaGaGaGaGaGaGaGaGaGaGaKaaacaaaaaaaaaaaaaaaaaaaaacagasatatatatatatatatatatatatakacaaaaaaaaaaaaaaaaaaaaaaaaaaaaaaaaaaaaaaaaaaaaaaaaaa
acaaaaaaaaaaaaaaaaaMaNaOaaaaaaaaaaaaaaaaacaaaaaaaaaaaaaaaaaaaaaaaaaMaNaOaaaaaaaaaaaaaaaaaaaaaaaaacaaaaaaaaaaaaaaaaaaaaacagasatatatatatatatatatatatatakacaaaaaaaaaaaaaaaaaaaaaaaaaaaaaaaaaaaaaaaaaaaaaaaaaa
acaaaaaaaaaaaaaaaaaaaaaaaaaaaaaaaaaaaaaaacaaaaaaaaaaaaaaaaaaaaaaaaaaaaaaaaaaaaaaaaaaaaaaaaaaaaaaacaaaaaaaaaaaaaaaaaaaaacagasatatatatatatatatatatatatakacaaaaaaaaaaaaaaaaaaaaaaaaaaaaaaaaaaaaaaaaaaaaaaaaaa
aPaPaPaPaPaPaPaPaPaPaPaPaPaPaPaPaPacacacacacacacacacacacacacacacacacacacacacacacacacacacacacacacacaaaaaaaaaaaaaaaaaaaaacagasatatatatatatatatatatatatakacaaaaaaaaaaaaaaaaaaaaaaaaaaaaaaaaaaaaaaaaaaaaaaaaaa
auauauauauauauauauauauauauauauauauacadaeaeaeaeaeafadaeaeaeaeaeafadaeaeaeaeaeafaaacaaaaaaaaaaaaaaaaaaaaaaaaaaaaaaaaaaaaacagasatatatatatatatatatatatatakacaaaaaaaaaaaaaaaaaaaaaaaaaaaaaaaaaaaaaaaaaaaaaaaaaa
auauauauauauauauauauauauauauauauauacagahaiaiaiaiawavahaiaiaiaiawavahaiaiaiaiakaaacaaaaaaaaaaaaaaaaaaaaaaaaaaaaaaaaaaaaacaFaGaGaGaGaGaHaQaJaGaGaGaGaGaKacaaaaaaaaaaaaaaaaaaaaaaaaaaaaaaaaaaaaaaaaaaaaaaaaaa
auauauauauauauauauauauauauauauauauacagalamaRamamazaSalamamamamazaSalamaRamamawafacaaaaaaaaaaaaaaaaaaaaaaaaaaaaaaaaaaaaacaaaaaaaaaaaaaMaTaOaaaaaaaaaaaaacaaaaaaaaaaaaaaaaaaaaaaaaaaaaaaaaaaaaaaaaaaaaaaaaaa
auauauauauauauauauauauauauauauauauacagaoapaUapapaBaVaoapapapapaBaVaoapaWapapazakacaaaaaaaaaaaaaaaaaaaaaaaaaaaaaaacacacacacacacacacacacacacacacacacacacacacacacaaaaaaaaaaaaaaaaaaaaaaaaaaaaaaaaaaaaaaaaaaaa
auauauauauauauauauauauauauauauauauacagaqararararaEaXaDararararaEaXaDararararaBakacaaaaaaaaaaaaaaaaaaaaaaaaaaaaaaacadaeaeaeaeaeafadaeaeaeaeaeafadaeaeaeaeaeafacaaaaaaaaaaaaaaaaaaaaaaaaaaaaaaaaaaaaaaaaaaaa
auauauauauauauauauauauauauauauauauacagasatatatatatatatatatatatatatatatatatataEakacaaaaaaaaaaaaaaaaaaaaaaaaaaaaaaacagahaiajaiaiawavahaiaiaiaiawavahaiajaiaiakacaaaaaaaaaaaaaaaaaaaaaaaaaaaaaaaaaaaaaaaaaaaa
auauauauauauauauauauauauauauauauauacagasatatatatatatatatatatatatatatatatatataYaZacaaaaaaaaaaaaaaaaaaaaaaaaaaaaaaacagalamanamamazaSalamamamamazaSalamanamamakacaaaaaaaaaaaaaaaaaaaaaaaaaaaaaaaaaaaaaaaaaaaa
auauauauauauauauauauauauauauauauauacagasatatatatatatatatatatatatatatatatatatbaaKacaaaaaaaaaaaaaaaaaaaaaaaaaaaaaaacagaoapapapapaBaVaobbbcapapaBaVaoapapapapakacaaaaaaaaaaaaaaaaaaaaaaaaaaaaaaaaaaaaaaaaaaaa
auauauauauauauauauauauauauauauauauacagasatatatatatatatatatatatatatatatatatatakaaacaaaaaaaaaaaaaaaaaaaaaaaaaaaaaaacagaqararararaEaXaDararararaEaXaDararararakacaaaaaaaaaaaaaaaaaaaaaaaaaaaaaaaaaaaaaaaaaaaa
auauauauauauauauauauauauauauauauauacaFaGaGaGaGaGaGaGaGaGaGaGaGaGaGaGaGaGaGaGaKaaacaaaaaaaaaaaaaaaaaaaaaaaaaaaaaaacagasatatatatatatatatatatatatatatatatatatakacaaaaaaaaaaaaaaaaaaaaaaaaaaaaaaaaaaaaaaaaaaaa
auauauauauauauauauauauauauauauauauacacacacacacacacacacacacacacacacacacacacacacacacaaaaaaaaaaaaaaaaaaaaaaaaaaaaaaacagasatatatatatatatatatatatatatatatatatatakacaaaaaaaaaaaaaaaaaaaaaaaaaaaaaaaaaaaaaaaaaaaa
auauauauauauauauauauauauauauauauauaaaaaaaaaaaaaaaaaaaaaaaaaaaaaaaaaaaaaaaaaaaaaaaaaaaaaaaaaaaaaaaaaaaaaaaaaaaaaaacagasatatatatatatatatatatatatatatatatatatakacaaaaaaaaaaaaaaaaaaaaaaaaaaaaaaaaaaaaaaaaaaaa
acacacacacacacacacacacacacacacacacacacacacacacacacacacacacacacacacacacacacacacacacaaaaaaaaaaaaaaaaaaaaaaaaaaaaaaacagasatatatatatatatatatatatatatatatatatatakacaaaaaaaaaaaaaaaaaaaaaaaaaaaaaaaaaaaaaaaaaaaa
acaaaaaaaaaaaaaaaaaaaaaaaaaaaaaaaaaaaaaaacaaaaaaaaaaaaaaaaaaaaaaaaaaaaaaaaaaaaaaacaaaaaaaaaaaaaaaaaaaaaaaaaaaaaaacaFaGbdbebfbebaaGaGaGaGaGaGaGbdbebgbebaaGaKacaaaaaaaaaaaaaaaaaaaaaaaaaaaaaaaaaaaaaaaaaaaa
acaaadaeaeaeaeaeaeaeaeaeaeaeaeaeaeaeafaaacaaadaeaeaeaeaeaeaeaeaeaeaeaeaeaeaeafaaacaaaaaaaaaaaaaaaaaaaaaaaaaaaaaaacaaaaaFaTaTaTaKaaaaaaaaaaaaaaaFaTaTaTaKaaaaacaaaaaaaaaaaaaaaaaaaaaaaaaaaaaaaaaaaaaaaaaaaa
acaaagahaiajaiaiaiaiaiaiaiaiaiajaiaiakaaacaaagahaiajaiaiaiaiaiaiaiaiaiajaiaiakaaacaaaaaaaaaaaaaaaaaaaaaaaaaaaaaaacaaaaaaaaaaaaaaaaaaaaaaaaaaaaaaaaaaaaaaaaaaacaaaaaaaaaaaaaaaaaaaaaaaaaaaaaaaaaaaaaaaaaaaa
acaaagalamanamamamamamamamamamanamamakaaacaaagalamanamamamamamamamamamanamamakaaacacacacacacacacacacacacacacacacacacacacacacacacacacacacacacacacacacacacacacacaaaaaaaaaaaaaaaaaaaaaaaaaaaaaaaaaaaaaaaaaaaa
acaaagaoapapapapapapapapapapapapapapakaaacaaagaoapapapapapapapapapapapapapapakaaacaaaaaaaaaaaaaaaaaaaaaaaaaaaaaaaaaaaaaaaaaaaaaaaaaaaaaaaaaaaaaaaaaaaaaaaaaaacaaaaaaaaaaaaaaaaaaaaaaaaaaaaaaaaaaaaaaaaaaaa
acaaagaqararararararararararararararakaaacaaagaqararararararararararararararakaaacaaaaaaaaaaaaaaaaaaaaaaaaaaadaeaeaeaeaeaeaeaeaeafaaaaaaaaaaaaaaaaaaaaaaaaaaacaaaaaaaaaaaaaaaaaaaaaaaaaaaaaaaaaaaaaaaaaaaa
acaaagasatatatatatatatatatatatatatatakaaacaaagasatatatatatatatatatatatatatatakaaacaaaaaaaaaaaaaaaaaaaaaaaaadavahaiajaiaiaiajaiaiawafaaaaaaaaaaaaaaaaaaaaaaaaacaaaaaaaaaaaaaaaaaaaaaaaaaaaaaaaaaaaaaaaaaaaa
acaaagasatatatatatatatatatatatatatatakaaacaaagasatatatatatatatatatatatatatatakaaacaaaaaaaaaaaaaaaaaaaaaaaaagaxalamanamamamanamamazakaaaaaaaaaaaaaaaaaaaaaaaaacaaaaaaaaaaaaaaaaaaaaaaaaaaaaaaaaaaaaaaaaaaaa
acaaagasatatatatatatatatatatatatatatakaaacaaagasatatatatatatatatatatatatatatakaaacaaaaaaaaaaaaaaaaaaaaaaaaagaAaoapapapapapapapapaBakaaaaaaaaaaaaaaaaaaaaaaaaacaaaaaaaaaaaaaaaaaaaaaaaaaaaaaaaaaaaaaaaaaaaa
acaaagasatatatatatatatatatatatatatatakaaacaaagasatatatatatatatatatatatatatatakaaacaaaaaaaaaaaaaaaaaaaaaaaaagaCaDararararararararaEakaaaaaaaaaaaaaaaaaaaaaaaaacaaaaaaaaaaaaaaaaaaaaaaaaaaaaaaaaaaaaaaaaaaaa
acaaagasatatatatatatatatatatatatatatakaaacaaagasatatatatatatatatatatatatatatakaaacaaaaaaaaaaaaaaaaaaaaaaaaagaqatatatatatatatatatatakaaaaaaaaaaaaaaaaaaaaaaaaacaaaaaaaaaaaaaaaaaaaaaaaaaaaaaaaaaaaaaaaaaaaa
acaaagasatatatatatatatatatatatatatatakaaacaaagasatatatatatatatatatatatatatatakaaacaaaaaaaaaaaaaaaaaaaaaaaaagasatatatatatatatatatatakaaaaaaaaaaaaaaaaaaaaaaaaacaaaaaaaaaaaaaaaaaaaaaaaaaaaaaaaaaaaaaaaaaaaa
acaaagasatatatatatatatatatatatatatatakaaacaaagasatatatatatatatatatatatatatatakaaacaaaaaaaaaaaaaaaaaaaaaaaaagasatatatatatatatatatatakaaaaaaaaaaaaaaaaaaaaaaaaacaaaaaaaaaaaaaaaaaaaaaaaaaaaaaaaaaaaaaaaaaaaa
acaaagasatatatatatatatatatatatatatatakaaacaaagasatatatatatatatatatatatatatatakaaacaaaaaaaaaaaaaaaaaaaaaaaaagasatatatatatatatatatatakaaaaaaaaaaaaaaaaaaaaaaaaacaaaaaaaaaaaaaaaaaaaaaaaaaaaaaaaaaaaaaaaaaaaa
acaaagasatatatatatatatatatatatatatatakaaacaaagasatatatatatatatatatatatatatatakaaacaaaaaaaaaaaaaaaaaaaaaaaaagasatatatatatatatatatatakaaaaaaaaaaaaaaaaaaaaaaaaacaaaaaaaaaaaaaaaaaaaaaaaaaaaaaaaaaaaaaaaaaaaa
acaaagasatatatatatatatatatatatatatatakaaacaaagasatatatatatatatatatatatatatatakaaacauadaebhbibhaeafaaaaaaaaagasatatatatatatatatatatakaaaaaaaaadaebhbibhaeafaaacaaaaaaaaaaaaaaaaaaaaaaaaaaaaaaaaaaaaaaaaaaaa
acaaaFaGaGaGaGaGaGaHaIaJaGaGaGaGaGaGaKaaacaaaFaGaGaGaGaGaGaHaLaJaGaGaGaGaGaGaKaaacauagaxbebfbeazakaaaaaaaaagasatatatatatatatatatatakaaaaaaaaagaxbebgbeazakaaacaaaaaaaaaaaaaaaaaaaaaaaaaaaaaaaaaaaaaaaaaaaa
acaaaaaaaaaaaaaaaaaMaNaOaaaaaaaaaaaaaaaaacaaaaaaaaaaaaaaaaaMaNaOaaaaaaaaaaaaaaaaacauagaAbjbjbjaBakaaaaaaaaagasatatatatatatatatatatakaaaaaaaaagaAbjbjbjaBakaaacaaaaaaaaaaaaaaaaaaaaaaaaaaaaaaaaaaaaaaaaaaaa
acaaaaaaaaaaaaaaaaaaaaaaaaaaaaaaaaaaaaaaacaaaaaaaaaaaaaaaaaaaaaaaaaaaaaaaaaaaaaaacauagaCbjbjbjaEakaaaaaaaaaFaGbdatatatatatatatbaaGaKaaaaaaaaagaCbjbjbjaEakaaacaaaaaaaaaaaaaaaaaaaaaaaaaaaaaaaaaaaaaaaaaaaa
acacacacacacacacacacacacacacacacacacacacacacacacacacacacacacacacacacacacacacacacacauagaqararararakaaaaaaaaaaaaagatatatatatatatakaaaaaaaaaaaaagaqararararakaaacaaaaaaaaaaaaaaaaaaaaaaaaaaaaaaaaaaaaaaaaaaaa
auauauauauauauauauauauauauauauauauacadaeaeaeaeaeafadaeaeaeaeaeafadaeaeaeaeaeafauacauagasatatatatawaeaeafadaeaeavatatatatatatatawaeaeafadaeaeavasatatatatakaaacaaaaaaaaaaaaaaaaaaaaaaaaaaaaaaaaaaaaaaaaaaaa
auauauauauauauauauauauauauauauauauacagahaiaiaiaiawavahaiaiaiaiawavahaiaiaiaiakauacauagasatatatatazaiaiawavahaiaSatatatatatatatazaiaiawavahaiaSasatatatatakaaacaaaaaaaaaaaaaaaaaaaaaaaaaaaaaaaaaaaaaaaaaaaa
auauauauauauauauauauauauauauauauauacagalamaRamamazaSalamamamamazaSalamaRamamawafacadavasatatatataBamamazaSalamaVbjbjbjbjbjbjbjaBamamazaSalamaVasatatatatawafacaaaaaaaaaaaaaaaaaaaaaaaaaaaaaaaaaaaaaaaaaaaa
auauauauauauauauauauauauauauauauauacagaoapaUapapaBaVaoapapapapaBaVaoapaWapapazakacagaxasatatatataEapapaBaVaoapaXatatatatatatataEapapaBaVaoapaXbkatatatatazakacaaaaaaaaaaaaaaaaaaaaaaaaaaaaaaaaaaaaaaaaaaaa
auauauauauauauauauauauauauauauauauacagaqararararaEaXaDararararaEaXaDararararaBakacagaAasatatatatarararaEaXaDararatatatatatatatarararaEaXaDararatatatatataBakacaaaaaaaaaaaaaaaaaaaaaaaaaaaaaaaaaaaaaaaaaaaa
auauauauauauauauauauauauauauauauauacagasatatatatatatatatatatatatatatatatatataEakacagaCasatatatatatatatatatatatatatatatatatatatatatatatatatatatatatatatataEakacaaaaaaaaaaaaaaaaaaaaaaaaaaaaaaaaaaaaaaaaaaaa
auauauauauauauauauauauauauauauauauacagasatatatatatatatatatatatatatatatatatatblaZacbmbnasatatatatatatatatatatatatatatatatatatatatatatatatatatatatatatatataYaZacaaaaaaaaaaaaaaaaaaaaaaaaaaaaaaaaaaaaaaaaaaaa
auauauauauauauauauauauauauauauauauacagasatatatatatatatatatatatatatatatatatatbaaKacaFbdasatatatatatatatatatatatatatatatatatatatatatatatatatatatatatatatatbaaKacaaaaaaaaaaaaaaaaaaaaaaaaaaaaaaaaaaaaaaaaaaaa
auauauauauauauauauauauauauauauauauacagasatatatatatatatatatatatatatatatatatatakaaacaaagasatatatatatatatbabdatatatatatboboboatatatatatbabdatatatatatatatatakaaacaaaaaaaaaaaaaaaaaaaaaaaaaaaaaaaaaaaaaaaaaaaa
auauauauauauauauauauauauauauauauauacaFaGaGaGaGaGaGaGaGaGaGaGaGaGaGaGaGaGaGaGaKaaacaaaFaGaGaGaGaGaGaGaGaKaFaGbdatatatboboboboatatbaaGaKaFaGaGaGaGaGaGaGaGaKaaacaaaaaaaaaaaaaaaaaaaaaaaaaaaaaaaaaaaaaaaaaaaa
auauauauauauauauauauauauauauauauauacacacacacacacacacacacacacacacacacacacacacacacacaaaaaaaaaaaaaaaaaaaaaaaaaaagatatatatatatatatatakaaaaaaaaaaaaaaaaaaaaaaaaaaacaaaaaaaaaaaaaaaaaaaaaaaaaaaaaaaaaaaaaaaaaaaa
auauauauauauauauauauauauauauauauauauauauauauauauauauauauauauauauauauauauauauauauacaaaaaaaaaaaaaaaaaaaaaaaaaaagatatatatatatatatatakaaaaaaaaaaaaaaaaaaaaaaaaaaacaaaaaaaaaaaaaaaaaaaaaaaaaaaaaaaaaaaaaaaaaaaa
auauauauauauauauauauauauauauauauauauauauauauauauauauauauauauauauauauauauauauauauacaaaaaaaaaaaaaaaaaaaaaaaaaaagatatatatatatatatatakaaaaaaaaaaaaaaaaaaaaaaaaaaacaaaaaaaaaaaaaaaaaaaaaaaaaaaaaaaaaaaaaaaaaaaa
auauauauauauauauauauauauauauauauauauauauauauauauauauauauauauauauauauauauauauauauacaaaaaaaaaaaaaaaaaaaaaaaaaaagatatatatatatatatatakaaaaaaaaaaaaaaaaaaaaaaaaaaacaaaaaaaaaaaaaaaaaaaaaaaaaaaaaaaaaaaaaaaaaaaa
auauauauauauauauauauauauauauauauauauauauauauauauauauauauauauauauauauauauauauauauacaaaaaaaaaaaaaaaaaaaaaaaaaaagatatatatatatatatatakaaaaaaaaaaaaaaaaaaaaaaaaaaacaaaaaaaaaaaaaaaaaaaaaaaaaaaaaaaaaaaaaaaaaaaa
auauauauauauauauauauauauauauauauauauauauauauauauauauauauauauauauauauauauauauauauacaaaaaaaaaaaaaaaaaaaaaaaaaaagatatatatatatatatatakaaaaaaaaaaaaaaaaaaaaaaaaaaacaaaaaaaaaaaaaaaaaaaaaaaaaaaaaaaaaaaaaaaaaaaa
auauauauauauauauauauauauauauauauauauauauauauauauauauauauauauauauauauauauauauauauacaaaaaaaaaaaaaaaaaaaaaaaaaaagatatatatbpatatatatakaaaaaaaaaaaaaaaaaaaaaaaaaaacaaaaaaaaaaaaaaaaaaaaaaaaaaaaaaaaaaaaaaaaaaaa
auauauauauauauauauauauauauauauauauauauauauauauauauauauauauauauauauauauauauauauauacaaaaaaaaaaaaaaaaaaaaaaaaaaaFbdatatatatatatatbaaKaaaaaaaaaaaaaaaaaaaaaaaaaaacaaaaaaaaaaaaaaaaaaaaaaaaaaaaaaaaaaaaaaaaaaaa
auauauauauauauauauauauauauauauauauauauauauauauauauauauauauauauauauauauauauauauauacaaaaaaaaaaaaaaaaaaaaaaaaaaaaaFaGaGaHbqaJaGaGaKaaaaaaaaaaaaaaaaaaaaaaaaaaaaacaaaaaaaaaaaaaaaaaaaaaaaaaaaaaaaaaaaaaaaaaaaa
auauauauauauauauauauauauauauauauauauauauauauauauauauauauauauauauauauauauauauauauacaaaaaaaaaaaaaaaaaaaaaaaaaaaaaaaaaaaMaNaOaaaaaaaaaaaaaaaaaaaaaaaaaaaaaaaaaaacaaaaaaaaaaaaaaaaaaaaaaaaaaaaaaaaaaaaaaaaaaaa
auauauauauauauauauauauauauauauauauauauauauauauauauauauauauauauauauauauauauauauauacacacacacacacacacacacacacacacacacacacacacacacacacacacacacacacacacacacacacacacaaaaaaaaaaaaaaaaaaaaaaaaaaaaaaaaaaaaaaaaaaaa
"}
