"a" = (/turf/void,/area)
"b" = (/turf,/area)
"c" = (/obj/map/noDenseMarker,/turf/village/roof_aphros/center_3,/area)
"d" = (/SmallPreview/End,/turf,/area)
"e" = (/obj/map/noDenseMarker,/turf/village/roof_aphros/left_3,/area)
"f" = (/obj/map/noDenseMarker,/turf/village/roof_aphros/center_2,/area)
"g" = (/obj/map/noDenseMarker,/turf/village/roof_aphros/right_3,/area)
"h" = (/turf/village/roof_aphros/left_2,/area)
"i" = (/turf/village/roof_aphros/center_2,/turf/village/horizontal_roof_aphros/top_left,/turf/village/roof_aphros/center_3{layer = 7},/area)
"j" = (/turf/village/roof_aphros/right_2,/turf/village/horizontal_roof_aphros/top_fill,/area)
"k" = (/MapLimit,/turf/void,/area)
"l" = (/obj/map/noDenseMarker,/turf/village/horizontal_roof_aphros/top_fill,/area)
"m" = (/obj/map/noDenseMarker,/turf/village/horizontal_roof_aphros/top_right,/area)
"n" = (/turf/village/roof_aphros/center_2,/area)
"o" = (/turf/village/horizontal_roof_aphros/fill,/turf/village/roof_aphros/right_3{layer = 7},/area)
"p" = (/turf/village/horizontal_roof_aphros/fill,/area)
"q" = (/obj/map/noDenseMarker,/turf/village/horizontal_roof_aphros/right,/area)
"r" = (/obj/map/noDenseMarker,/turf/village/roof_aphros/left_5,/area)
"s" = (/turf/village/wall_aphros/middle,/turf/village/roof_aphros/center_1,/area)
"t" = (/turf/village/roof_aphros/right_2,/area)
"u" = (/obj/map/noDenseMarker,/turf/village/roof_aphros/left_6,/area)
"v" = (/turf/village/wall_aphros/middle,/turf/village/roof_aphros/left_1,/area)
"w" = (/turf/village/wall_aphros/middle,/turf/village/roof_aphros/right_4,/turf/village/roof_aphros/left_4,/area)
"x" = (/turf/village/wall_aphros/middle,/turf/village/roof_aphros/right_1,/area)
"y" = (/turf/village/wall_aphros/middle,/turf/village/roof_aphros/left_4,/area)
"z" = (/turf/village/wall_aphros/middle,/area)
"A" = (/turf/village/wall_aphros/middle,/turf/village/roof_aphros/right_4,/area)
"B" = (/turf/village/roof_aphros/right_3,/obj/map/noDenseMarker,/turf/village/horizontal_roof_aphros/top_fill,/area)
"C" = (/turf/village/wall_aphros/middle,/turf/village/horizontal_roof_aphros/bottom_fill,/obj/generic_shadow/white{alpha = 50; color = "black"; icon_state = "full"},/turf/village/roof_aphros/right_5{density = 0; layer = 7},/area)
"D" = (/turf/village/wall_aphros/middle_right,/turf/village/horizontal_roof_aphros/bottom_fill,/area)
"E" = (/obj/map/noDenseMarker,/turf/village/horizontal_roof_aphros/bottom_right,/area)
"F" = (/turf/village/wall_aphros/middle_left,/turf/village/roof_aphros/left_1,/area)
"G" = (/turf/village/wall_aphros/middle,/turf/village/roof_aphros/left_4,/turf/village/aphros_extra/windowbig_2,/area)
"H" = (/turf/village/wall_aphros/middle,/turf/village/roof_aphros/right_4,/turf/village/aphros_extra/windowbig_2,/area)
"I" = (/turf/village/wall_aphros/middle_right,/turf/village/roof_aphros/right_1,/area)
"J" = (/turf/village/wall_aphros/middle,/BuildingDetails{building_category = "Aphros"; building_cost = 25000; building_desc = "A building with 2 rooms."; building_guild = "Aphros"; building_name = "A-Small House A"; building_settlement_only = 1},/turf/village/horizontal_roof_aphros/bottom_fill,/area)
"K" = (/turf/village/wall_aphros/middle,/turf/village/aphros_extra/door_top,/area)
"L" = (/turf/village/wall_aphros/middle_right,/area)
"M" = (/obj/map/noDenseMarker,/turf/village/roof_aphros/left_7,/area)
"N" = (/turf/village/wall_aphros/middle_left,/turf/village/roof_aphros/left_4,/area)
"O" = (/turf/village/wall_aphros/middle,/turf/village/aphros_extra/windowbig_1,/turf/house/wooden_window{density = 1; icon_state = "foilage2_top"; layer = 9},/area)
"P" = (/turf/village/wall_aphros/middle_right,/turf/village/roof_aphros/right_4,/area)
"Q" = (/turf/village/wall_aphros/middle,/obj/generic_shadow/white{alpha = 50; color = "black"; icon_state = "full"},/turf/village/roof_aphros/right_6{layer = 3},/area)
"R" = (/Building/Warper/Exterior,/turf/village/aphros_extra/door_bottom,/Region{desc = "Osrona's merchant district, Caelfall has a high number of shops and large homes for those more well off than the majority of the population. Within the middle is a large park with a small body of water within it's center. The jail, as well as the City Watch's headquarters is also known to be found here."; name = "Caelfall"})
"S" = (/turf/village/wall_aphros/bottom_right,/Region{desc = "Osrona's merchant district, Caelfall has a high number of shops and large homes for those more well off than the majority of the population. Within the middle is a large park with a small body of water within it's center. The jail, as well as the City Watch's headquarters is also known to be found here."; name = "Caelfall"})
"T" = (/SmallPreview/Start,/turf,/area)
"U" = (/turf/village/wall_aphros/bottom_left,/area)
"V" = (/turf/village/wall_aphros/bottom,/turf/house/wooden_window{density = 1; icon_state = "foilage2_bottom"; layer = 4},/area)
"W" = (/turf/village/wall_aphros/bottom,/Region{desc = "Osrona's merchant district, Caelfall has a high number of shops and large homes for those more well off than the majority of the population. Within the middle is a large park with a small body of water within it's center. The jail, as well as the City Watch's headquarters is also known to be found here."; name = "Caelfall"})
"X" = (/turf/village/wall_aphros/bottom,/turf/house/wooden_window{density = 1; icon_state = "foilage2_bottom"; layer = 4},/Region{desc = "Osrona's merchant district, Caelfall has a high number of shops and large homes for those more well off than the majority of the population. Within the middle is a large park with a small body of water within it's center. The jail, as well as the City Watch's headquarters is also known to be found here."; name = "Caelfall"})
"Y" = (/obj/generic_shadow/white{alpha = 50; color = "black"; icon_state = "tl_corner"},/turf,/area)
"Z" = (/turf/village/wall_aphros/bottom,/obj/generic_shadow/white{alpha = 50; color = "black"; icon_state = "full"},/turf/village/roof_aphros/right_7{layer = 7},/Region{desc = "Osrona's merchant district, Caelfall has a high number of shops and large homes for those more well off than the majority of the population. Within the middle is a large park with a small body of water within it's center. The jail, as well as the City Watch's headquarters is also known to be found here."; name = "Caelfall"})

(1,1,1) = {"
aaaaaaaaaaaaaaaak
aabbbbcbbbbbbdaaa
aabbbefgbbbbbbaaa
aabbehijBllllmaaa
aabehhnopppppqaaa
aarhhhstoppppqaaa
aauhhvwxtopppqaaa
aauhvyzAxtCJDEaaa
aauFGzzzHIQKLbaaa
aaMNOzzzOPZRSbaaa
aaTUVWWWXSYbbbaaa
aaaaaaaaaaaaaaaaa
aaaaaaaaaaaaaaaaa
"}
