"a" = (/turf/void,/area)
"b" = (/turf,/area)
"c" = (/obj/map/noDenseMarker,/turf/village/roof_aphros/center_3,/area)
"d" = (/SmallPreview/End,/turf,/area)
"e" = (/obj/map/noDenseMarker,/turf/village/roof_aphros/left_3,/area)
"f" = (/obj/map/noDenseMarker,/turf/village/roof_aphros/center_2,/area)
"g" = (/obj/map/noDenseMarker,/turf/village/roof_aphros/right_3,/area)
"h" = (/obj/map/noDenseMarker,/turf/village/horizontal_roof_aphros/top_left,/area)
"i" = (/obj/map/noDenseMarker,/turf/village/horizontal_roof_aphros/top_fill,/area)
"j" = (/MapLimit,/turf/void,/area)
"k" = (/turf/village/roof_aphros/left_2,/turf/village/horizontal_roof_aphros/top_fill,/area)
"l" = (/turf/village/roof_aphros/center_2,/turf/village/horizontal_roof_aphros/top_right,/turf/village/roof_aphros/center_3{layer = 7},/area)
"m" = (/turf/village/roof_aphros/right_2,/area)
"n" = (/obj/map/noDenseMarker,/turf/village/horizontal_roof_aphros/left,/area)
"o" = (/turf/village/horizontal_roof_aphros/fill,/area)
"p" = (/turf/village/horizontal_roof_aphros/fill,/turf/village/roof_aphros/left_3{layer = 7},/area)
"q" = (/turf/village/roof_aphros/center_2,/area)
"r" = (/turf/village/roof_aphros/left_2,/area)
"s" = (/turf/village/wall_aphros/middle,/turf/village/roof_aphros/center_1,/area)
"t" = (/obj/map/noDenseMarker,/turf/village/roof_aphros/right_5,/area)
"u" = (/turf/village/wall_aphros/middle,/turf/village/roof_aphros/left_1,/area)
"v" = (/turf/village/wall_aphros/middle,/turf/village/roof_aphros/right_4,/turf/village/roof_aphros/left_4,/area)
"w" = (/turf/village/wall_aphros/middle,/turf/village/roof_aphros/right_1,/area)
"x" = (/obj/map/noDenseMarker,/turf/village/roof_aphros/right_6,/area)
"y" = (/obj/map/noDenseMarker,/turf/village/horizontal_roof_aphros/bottom_left,/area)
"z" = (/turf/village/wall_aphros/middle_left,/turf/village/horizontal_roof_aphros/bottom_fill,/area)
"A" = (/turf/village/roof_aphros/left_3,/obj/map/noDenseMarker,/turf/village/horizontal_roof_aphros/top_fill,/area)
"B" = (/turf/village/wall_aphros/middle,/turf/village/horizontal_roof_aphros/bottom_fill,/turf/village/roof_aphros/left_5{density = 0; layer = 7},/area)
"C" = (/turf/village/wall_aphros/middle,/turf/village/roof_aphros/left_4,/area)
"D" = (/turf/village/wall_aphros/middle,/area)
"E" = (/turf/village/wall_aphros/middle,/turf/village/roof_aphros/right_4,/area)
"F" = (/turf/village/wall_aphros/middle_left,/area)
"G" = (/turf/village/wall_aphros/middle,/turf/village/aphros_extra/door_top,/area)
"H" = (/turf/village/wall_aphros/middle,/turf/village/roof_aphros/left_6,/area)
"I" = (/turf/village/wall_aphros/middle_left,/turf/village/roof_aphros/left_1,/area)
"J" = (/turf/village/wall_aphros/middle,/turf/village/roof_aphros/left_4,/turf/village/aphros_extra/windowbig_2,/area)
"K" = (/turf/village/wall_aphros/middle,/turf/village/roof_aphros/right_4,/turf/village/aphros_extra/windowbig_2,/area)
"L" = (/turf/village/wall_aphros/middle_right,/turf/village/roof_aphros/right_1,/area)
"M" = (/turf/village/wall_aphros/bottom_left,/area)
"N" = (/Building/Warper/Exterior,/turf/village/aphros_extra/door_bottom,/area)
"O" = (/turf/village/wall_aphros/bottom,/turf/village/roof_aphros/left_7,/Region{desc = "Osrona's merchant district, Caelfall has a high number of shops and large homes for those more well off than the majority of the population. Within the middle is a large park with a small body of water within it's center. The jail, as well as the City Watch's headquarters is also known to be found here."; name = "Caelfall"})
"P" = (/turf/village/wall_aphros/middle_left,/turf/village/roof_aphros/left_4,/area)
"Q" = (/turf/village/wall_aphros/middle,/turf/village/aphros_extra/windowbig_1,/turf/house/wooden_window{density = 1; icon_state = "foilage2_top"; layer = 9},/area)
"R" = (/turf/village/wall_aphros/middle_right,/turf/village/roof_aphros/right_4,/area)
"S" = (/obj/map/noDenseMarker,/turf/village/roof_aphros/right_7,/area)
"T" = (/SmallPreview/Start,/turf,/area)
"U" = (/turf/village/wall_aphros/bottom,/turf/house/wooden_window{density = 1; icon_state = "foilage2_bottom"; layer = 4},/area)
"V" = (/turf/village/wall_aphros/bottom,/Region{desc = "Osrona's merchant district, Caelfall has a high number of shops and large homes for those more well off than the majority of the population. Within the middle is a large park with a small body of water within it's center. The jail, as well as the City Watch's headquarters is also known to be found here."; name = "Caelfall"})
"W" = (/turf/village/wall_aphros/bottom,/turf/house/wooden_window{density = 1; icon_state = "foilage2_bottom"; layer = 4},/Region{desc = "Osrona's merchant district, Caelfall has a high number of shops and large homes for those more well off than the majority of the population. Within the middle is a large park with a small body of water within it's center. The jail, as well as the City Watch's headquarters is also known to be found here."; name = "Caelfall"})
"X" = (/turf/village/wall_aphros/bottom_right,/Region{desc = "Osrona's merchant district, Caelfall has a high number of shops and large homes for those more well off than the majority of the population. Within the middle is a large park with a small body of water within it's center. The jail, as well as the City Watch's headquarters is also known to be found here."; name = "Caelfall"})
"Y" = (/turf/village/wall_aphros/middle,/BuildingDetails{building_category = "Aphros"; building_cost = 25000; building_desc = "A building with 2 rooms."; building_guild = "Aphros"; building_name = "A-Small House C"; building_settlement_only = 1},/turf/village/horizontal_roof_aphros/bottom_fill,/area)

(1,1,1) = {"
aaaaaaaaaaaaaaaaj
aabbbbbbbcbbbdaaa
aabbbbbbefgbbbaaa
aahiiiiAklmgbbaaa
aanooooopqmmgbaaa
aanooooprsmmmtaaa
aanooopruvwmmxaaa
aayzYBruCDEwmxaaa
aabFGHIJDDDKLxaaa
aabMNOPQDDDQRSaaa
aaTbbbMUVVVWXbaaa
aaaaaaaaaaaaaaaaa
aaaaaaaaaaaaaaaaa
"}
