"aa" = (/turf/void,/area)
"ab" = (/turf,/area)
"ac" = (/obj/map/noDenseMarker,/turf/village/roof_vdalion2/center_3,/area)
"ad" = (/SmallPreview/End,/turf,/area)
"ae" = (/obj/map/noDenseMarker,/turf/village/roof_vdalion2/left_3,/area)
"af" = (/obj/map/noDenseMarker,/turf/village/roof_vdalion2/center_2,/area)
"ag" = (/obj/map/noDenseMarker,/turf/village/roof_vdalion2/right_3,/area)
"ah" = (/turf/village/roof_vdalion2/left_2,/area)
"ai" = (/turf/village/roof_vdalion2/center_2,/turf/village/horizontal_roof_vdalion2/top_left,/turf/village/roof_vdalion2/center_3{layer = 7},/area)
"aj" = (/turf/village/roof_vdalion2/right_2,/turf/village/horizontal_roof_vdalion2/top_fill,/area)
"ak" = (/MapLimit,/turf/void,/area)
"al" = (/obj/map/noDenseMarker,/turf/village/horizontal_roof_vdalion2/top_fill,/area)
"am" = (/obj/map/noDenseMarker,/turf/village/horizontal_roof_vdalion2/top_right,/area)
"an" = (/turf/village/roof_vdalion2/center_2,/area)
"ao" = (/turf/village/horizontal_roof_vdalion2/fill,/turf/village/roof_vdalion2/right_3{layer = 7},/area)
"ap" = (/turf/village/horizontal_roof_vdalion2/fill,/area)
"aq" = (/obj/map/noDenseMarker,/turf/village/horizontal_roof_vdalion2/right,/area)
"ar" = (/obj/map/noDenseMarker,/turf/village/roof_vdalion2/left_5,/area)
"as" = (/turf/village/wall_vdalion/top_middle,/turf/village/roof_vdalion2/center_1,/area)
"at" = (/turf/village/roof_vdalion2/right_2,/area)
"au" = (/obj/map/noDenseMarker,/turf/village/roof_vdalion2/left_6,/area)
"av" = (/turf/village/wall_vdalion/top_middle,/turf/village/roof_vdalion2/left_1,/area)
"aw" = (/turf/village/wall_vdalion/top_middle,/turf/village/roof_vdalion2/left_4,/turf/village/roof_vdalion2/right_4,/area)
"ax" = (/turf/village/wall_vdalion/top_middle,/turf/village/roof_vdalion2/right_1,/area)
"ay" = (/turf/village/wall_vdalion/top_middle,/turf/village/roof_vdalion2/left_4,/area)
"az" = (/turf/village/wall_vdalion/top_middle,/area)
"aA" = (/turf/village/wall_vdalion/top_middle,/turf/village/roof_vdalion2/right_4,/area)
"aB" = (/turf/village/roof_vdalion2/right_3,/obj/map/noDenseMarker,/turf/village/horizontal_roof_vdalion2/top_fill,/area)
"aC" = (/turf/village/wall_vdalion/top_middle,/turf/village/horizontal_roof_vdalion2/bottom_fill,/area)
"aD" = (/turf/village/wall_vdalion/top_middle,/turf/village/vdalion_extra/windowbig_4,/turf/village/horizontal_roof_vdalion2/bottom_fill,/area)
"aE" = (/turf/village/wall_vdalion/top_right,/turf/village/horizontal_roof_vdalion2/bottom_fill,/area)
"aF" = (/obj/map/noDenseMarker,/turf/village/horizontal_roof_vdalion2/bottom_right,/area)
"aG" = (/turf/village/wall_vdalion/top_left,/turf/village/roof_vdalion2/left_1,/area)
"aH" = (/turf/village/wall_vdalion/top_middle,/turf/village/roof_vdalion2/left_4,/turf/village/vdalion_extra/windowbig_4,/area)
"aI" = (/turf/village/wall_vdalion/top_middle,/turf/village/roof_vdalion2/right_4,/turf/village/vdalion_extra/windowbig_4,/area)
"aJ" = (/turf/village/wall_vdalion/top_right,/turf/village/roof_vdalion2/right_1,/area)
"aK" = (/turf/village/wall_vdalion/top_middle,/turf/village/horizontal_roof_vdalion2/bottom_fill,/obj/generic_shadow/white{alpha = 50; color = "black"; icon_state = "full"},/turf/village/roof_vdalion2/right_5{layer = 7},/area)
"aL" = (/turf/village/wall_vdalion/top_middle,/turf/village/vdalion_extra/windowbig_3,/area)
"aM" = (/turf/village/wall_vdalion/top_right,/area)
"aN" = (/obj/map/noDenseMarker,/turf/village/roof_vdalion2/left_7,/area)
"aO" = (/turf/village/wall_vdalion/top_left,/turf/village/roof_vdalion2/left_4,/area)
"aP" = (/turf/village/wall_vdalion/top_right,/turf/village/roof_vdalion2/right_4,/area)
"aQ" = (/turf/village/wall_vdalion/top_middle,/obj/generic_shadow/white{alpha = 50; color = "black"; icon_state = "full"},/turf/village/roof_vdalion2/right_6{layer = 7; name = "right 6_1"},/area)
"aR" = (/turf/village/wall_vdalion/middle,/area)
"aS" = (/turf/village/wall_vdalion/middle,/turf/village/vdalion_extra/windowbig_5,/area)
"aT" = (/turf/village/wall_vdalion/middle_right,/area)
"aU" = (/turf/village/wall_vdalion/middle_left,/area)
"aV" = (/obj/generic_shadow/white{alpha = 75; color = "black"; icon_state = "top"},/obj/generic_shadow/white{alpha = 50; color = "black"; icon_state = "tl_corner"; name = "house shadow corner"},/turf/inn/floor,/Region{desc = "Osrona's merchant district, Caelfall has a high number of shops and large homes for those more well off than the majority of the population. Within the middle is a large park with a small body of water within it's center. The jail, as well as the City Watch's headquarters is also known to be found here."; name = "Caelfall"})
"aW" = (/obj/generic_shadow/white{alpha = 75; color = "black"; icon_state = "top"},/turf/inn/floor,/Region{desc = "Osrona's merchant district, Caelfall has a high number of shops and large homes for those more well off than the majority of the population. Within the middle is a large park with a small body of water within it's center. The jail, as well as the City Watch's headquarters is also known to be found here."; name = "Caelfall"})
"aX" = (/turf/village/wall_vdalion/middle,/obj/generic_shadow/white{alpha = 50; color = "black"; icon_state = "full"},/turf/village/roof_vdalion2/right_7{layer = 7; name = "right 7_1"},/area)
"aY" = (/obj/generic_shadow/white{alpha = 50; color = "black"; icon_state = "full"},/turf/village/wall_vdalion/bottom_right,/area)
"aZ" = (/turf/village/wall_vdalion/bottom_left,/area)
"ba" = (/turf/inn/floor,/obj/generic_shadow/white{alpha = 75; color = "black"; icon_state = "top"},/turf/inn/rail/right{layer = 3.2},/Region{desc = "Osrona's merchant district, Caelfall has a high number of shops and large homes for those more well off than the majority of the population. Within the middle is a large park with a small body of water within it's center. The jail, as well as the City Watch's headquarters is also known to be found here."; name = "Caelfall"})
"bb" = (/turf/inn/floor,/Region{desc = "Osrona's merchant district, Caelfall has a high number of shops and large homes for those more well off than the majority of the population. Within the middle is a large park with a small body of water within it's center. The jail, as well as the City Watch's headquarters is also known to be found here."; name = "Caelfall"})
"bc" = (/turf/inn/floor,/turf/inn/rail/right{layer = 3.2},/Region{desc = "Osrona's merchant district, Caelfall has a high number of shops and large homes for those more well off than the majority of the population. Within the middle is a large park with a small body of water within it's center. The jail, as well as the City Watch's headquarters is also known to be found here."; name = "Caelfall"})
"bd" = (/turf/inn/floor,/turf/inn/rail/middle,/Region{desc = "Osrona's merchant district, Caelfall has a high number of shops and large homes for those more well off than the majority of the population. Within the middle is a large park with a small body of water within it's center. The jail, as well as the City Watch's headquarters is also known to be found here."; name = "Caelfall"})
"be" = (/turf/inn/floor,/turf/shop_int/stairs/top_left,/Region{desc = "Osrona's merchant district, Caelfall has a high number of shops and large homes for those more well off than the majority of the population. Within the middle is a large park with a small body of water within it's center. The jail, as well as the City Watch's headquarters is also known to be found here."; name = "Caelfall"})
"bf" = (/turf/inn/floor,/turf/shop_int/stairs/top,/Region{desc = "Osrona's merchant district, Caelfall has a high number of shops and large homes for those more well off than the majority of the population. Within the middle is a large park with a small body of water within it's center. The jail, as well as the City Watch's headquarters is also known to be found here."; name = "Caelfall"})
"bg" = (/turf/inn/floor,/turf/shop_int/stairs/top_right,/Region{desc = "Osrona's merchant district, Caelfall has a high number of shops and large homes for those more well off than the majority of the population. Within the middle is a large park with a small body of water within it's center. The jail, as well as the City Watch's headquarters is also known to be found here."; name = "Caelfall"})
"bh" = (/obj/generic_shadow/white{alpha = 50; color = "black"; icon_state = "full"},/turf/village/wall_vdalion/foundation_right,/Region{desc = "Osrona's merchant district, Caelfall has a high number of shops and large homes for those more well off than the majority of the population. Within the middle is a large park with a small body of water within it's center. The jail, as well as the City Watch's headquarters is also known to be found here."; name = "Caelfall"})
"bi" = (/turf/village/wall_vdalion/foundation_left,/area)
"bj" = (/turf/village/wall_vdalion/bottom_left,/turf/jianghu_house/shadow{density = 1},/area)
"bk" = (/turf/shop_int/stairs/left,/Region{desc = "Osrona's merchant district, Caelfall has a high number of shops and large homes for those more well off than the majority of the population. Within the middle is a large park with a small body of water within it's center. The jail, as well as the City Watch's headquarters is also known to be found here."; name = "Caelfall"})
"bl" = (/turf/shop_int/stairs/middle,/Region{desc = "Osrona's merchant district, Caelfall has a high number of shops and large homes for those more well off than the majority of the population. Within the middle is a large park with a small body of water within it's center. The jail, as well as the City Watch's headquarters is also known to be found here."; name = "Caelfall"})
"bm" = (/turf/shop_int/stairs/right,/Region{desc = "Osrona's merchant district, Caelfall has a high number of shops and large homes for those more well off than the majority of the population. Within the middle is a large park with a small body of water within it's center. The jail, as well as the City Watch's headquarters is also known to be found here."; name = "Caelfall"})
"bn" = (/turf/inn/floor,/obj/generic_shadow/white{alpha = 75; color = "black"; icon_state = "top"},/turf/inn/rail/left{layer = 3.2},/Region{desc = "Osrona's merchant district, Caelfall has a high number of shops and large homes for those more well off than the majority of the population. Within the middle is a large park with a small body of water within it's center. The jail, as well as the City Watch's headquarters is also known to be found here."; name = "Caelfall"})
"bo" = (/turf/village/wall_vdalion/bottom,/obj/generic_shadow/white{alpha = 50; color = "black"; icon_state = "full"},/turf/jianghu_house/shadow{density = 1},/area)
"bp" = (/turf/village/wall_vdalion/bottom,/turf/jianghu_house/shadow{density = 1},/turf/village/vdalion_extra/windowbig_4,/area)
"bq" = (/turf/village/wall_vdalion/bottom,/turf/jianghu_house/shadow{density = 1},/area)
"br" = (/turf/village/wall_vdalion/bottom_right,/turf/jianghu_house/shadow{density = 1},/area)
"bs" = (/obj/generic_shadow/white{alpha = 50; color = "black"; icon_state = "full"},/turf,/area)
"bt" = (/obj/generic_shadow/white{alpha = 50; color = "black"; icon_state = "full"},/turf/village/wall_vdalion/bottom,/area)
"bu" = (/turf/village/wall_vdalion/bottom,/turf/village/vdalion_extra/door_top,/area)
"bv" = (/turf/village/wall_vdalion/bottom,/turf/village/vdalion_extra/windowbig_3,/area)
"bw" = (/turf/village/wall_vdalion/bottom,/area)
"bx" = (/turf/village/wall_vdalion/bottom_right,/area)
"by" = (/obj/generic_shadow/white{alpha = 50; color = "black"; icon_state = "full"},/turf/village/wall_vdalion/foundation_middle,/Region{desc = "Osrona's merchant district, Caelfall has a high number of shops and large homes for those more well off than the majority of the population. Within the middle is a large park with a small body of water within it's center. The jail, as well as the City Watch's headquarters is also known to be found here."; name = "Caelfall"})
"bz" = (/Building/Warper/Exterior,/turf/village/vdalion_extra/door_bottom,/Region{desc = "Osrona's merchant district, Caelfall has a high number of shops and large homes for those more well off than the majority of the population. Within the middle is a large park with a small body of water within it's center. The jail, as well as the City Watch's headquarters is also known to be found here."; name = "Caelfall"})
"bA" = (/turf/village/wall_vdalion/foundation_middle,/Region{desc = "Osrona's merchant district, Caelfall has a high number of shops and large homes for those more well off than the majority of the population. Within the middle is a large park with a small body of water within it's center. The jail, as well as the City Watch's headquarters is also known to be found here."; name = "Caelfall"})
"bB" = (/turf/village/wall_vdalion/foundation_right,/Region{desc = "Osrona's merchant district, Caelfall has a high number of shops and large homes for those more well off than the majority of the population. Within the middle is a large park with a small body of water within it's center. The jail, as well as the City Watch's headquarters is also known to be found here."; name = "Caelfall"})
"bC" = (/obj/generic_shadow/white{alpha = 50; color = "black"; icon_state = "tl_corner"; name = "house shadow corner"},/turf,/area)
"bD" = (/SmallPreview/Start,/turf,/area)
"bE" = (/turf/city/wall/blue{icon_state = "Left"},/turf/shop_int/stairs/bottom_left,/Region{desc = "Osrona's merchant district, Caelfall has a high number of shops and large homes for those more well off than the majority of the population. Within the middle is a large park with a small body of water within it's center. The jail, as well as the City Watch's headquarters is also known to be found here."; name = "Caelfall"})
"bF" = (/turf/shop_int/stairs/bottom,/Region{desc = "Osrona's merchant district, Caelfall has a high number of shops and large homes for those more well off than the majority of the population. Within the middle is a large park with a small body of water within it's center. The jail, as well as the City Watch's headquarters is also known to be found here."; name = "Caelfall"})
"bG" = (/turf/city/wall/blue{density = 0; icon_state = "Right"},/turf/shop_int/stairs/bottom_right,/Region{desc = "Osrona's merchant district, Caelfall has a high number of shops and large homes for those more well off than the majority of the population. Within the middle is a large park with a small body of water within it's center. The jail, as well as the City Watch's headquarters is also known to be found here."; name = "Caelfall"})
"bH" = (/turf/village/wall_vdalion/bottom,/BuildingDetails{building_category = "Vdalion"; building_cost = 50000; building_desc = "An apartment complex."; building_guild = "Vdalion"; building_interior = 0; building_name = "V-Apartment"; building_settlement_only = 1},/turf/jianghu_house/shadow{density = 1},/area)

(1,1,1) = {"
aaababababacabababababababababababababadak
aaabababaeafagabababababababababababababaa
aaababaeahaiajaBalalalalalalalalalalalamaa
aaabaeahahanaoapapapapapapapapapapapapaqaa
aaarahahahasataoapapapapapapapapapapapaqaa
aaauahahavawaxataoapapapapapapapapapapaqaa
aaauahavayazaAaxataKaCaDaCaDaCaDaCaCaEaFaa
aaauaGaHazazazaIaJaQazaLazaLazaLazazaMabaa
aaaNaOaLazazazaLaPaXaRaSaRaSaRaSaRaRaTabaa
aaabaUaSaRaRaRaSaTaVaWaWaWaWaWaWaWbaaYabaa
aaabaZbnaWaWaWaWaWbbbbbbbbbbbbbbbbbcaYabaa
aaabaZbdbebfbgbdbdbdbdbdbdbdbdbdbdbdbhabaa
aaabbibjbkblbmbobHbpbqbpbqbpbqbpbqbrbsabaa
aaababaZbkblbmbtbubvbwbvbwbvbwbvbwbxbsabaa
aaababbibkblbmbybzbAbAbAbAbAbAbAbAbBbCabaa
aabDababbEbFbGbCababababababababababababaa
aaaaaaaaaaaaaaaaaaaaaaaaaaaaaaaaaaaaaaaaaa
"}
