"aa" = (/turf/void,/area)
"ab" = (/MapLimit,/turf/void,/area)
"ac" = (/obj/map/viewBlock,/turf/void,/area)
"ad" = (/turf/house/roof/corner/br,/area)
"ae" = (/turf/house/roof/bottom,/area)
"af" = (/turf/house/roof/corner/bl,/area)
"ag" = (/turf/house/roof/bottom_right,/area)
"ah" = (/turf/village/wall_vdalion/bottom,/area)
"ai" = (/turf/house/roof/bottom_left,/area)
"aj" = (/turf/village/wall_vdalion/bottom,/turf/jianghu_house/shadow{density = 1},/area)
"ak" = (/turf/village/wall_vdalion/bottom_right,/turf/jianghu_house/shadow{density = 1},/area)
"al" = (/turf/village/wall_vdalion/bottom_left,/turf/jianghu_house/shadow{density = 1},/area)
"am" = (/turf/village/wall_vdalion/bottom_right,/area)
"an" = (/obj/map/shop_int/window,/obj/map/generic_light{alpha = 200; layer = 5; light_size = 2; name = "light_cyan_big"},/turf/village/wall_vdalion/bottom,/area)
"ao" = (/turf/village/wall_vdalion/bottom_left,/area)
"ap" = (/turf/house/roof/right,/area)
"aq" = (/turf/house/roof/left,/area)
"ar" = (/turf/village/wall_vdalion/foundation_middle,/area)
"as" = (/turf/castle_int/floor,/area)
"at" = (/turf/village/wall_vdalion/foundation_left,/area)
"au" = (/turf/village/wall_vdalion/foundation_right,/area)
"av" = (/Building/Warper/Dynamic{dynamic_id = "HighWest-V-Church"},/turf/castle_int/floor,/area)
"aw" = (/turf/house/roof/top_left,/area)
"ax" = (/turf/house/roof/corner/tl,/area)
"ay" = (/Building/Warper/Dynamic{dynamic_id = "HighEast-V-Church"},/turf/castle_int/floor,/area)
"az" = (/turf/castle_int/floor,/turf/shop_int/stairs/top_left,/area)
"aA" = (/turf/castle_int/floor,/turf/shop_int/stairs/top,/area)
"aB" = (/turf/castle_int/floor,/turf/shop_int/stairs/top_right,/area)
"aC" = (/turf/castle_int/floor,/turf/shop_int/stairs/rail,/area)
"aD" = (/turf/house/roof/corner/tr,/area)
"aE" = (/turf/house/roof/top_right,/area)
"aF" = (/turf/shop_int/stairs/left,/area)
"aG" = (/turf/shop_int/stairs/middle,/area)
"aH" = (/turf/shop_int/stairs/right,/area)
"aI" = (/turf/village/wall_vdalion/top_middle,/area)
"aJ" = (/turf/village/wall_vdalion/top_right,/area)
"aK" = (/turf/castle_int/floor,/turf/village/road_brown/bottom,/area)
"aL" = (/turf/castle_int/floor,/turf/village/road_brown/t_l,/area)
"aM" = (/turf/castle_int/floor,/turf/village/road_brown/t_r,/area)
"aN" = (/turf/village/wall_vdalion/middle,/area)
"aO" = (/turf/village/wall_vdalion/middle_right,/area)
"aP" = (/turf/castle_int/floor,/turf/village/road_brown/bottom_left,/area)
"aQ" = (/turf/castle_int/floor,/turf/village/road_brown/bottom_right,/area)
"aR" = (/turf/inn/floor,/turf/shop_int/stairs/bottom_left,/area)
"aS" = (/turf/inn/floor,/turf/shop_int/stairs/bottom_right,/area)
"aT" = (/Building/Warper/Dynamic{dynamic_id = "LowWest-V-Church"},/turf/castle_int/floor,/area)
"aU" = (/obj/map/cave_light,/turf/house/roof/left,/area)
"aV" = (/turf/house/roof/top,/area)
"aW" = (/obj/map/cave_light,/turf/house/roof/right,/area)
"aX" = (/Building/Warper/Dynamic{dynamic_id = "LowEast-V-Church"},/turf/castle_int/floor,/area)
"aY" = (/BuildingDetails{building_category = "Vdalion"; building_cost = 50000; building_desc = "A Church building."; building_guild = "Vdalion"; building_interior = 1; building_name = "V-Church"},/turf/castle_int/floor,/area)
"aZ" = (/obj/map/DenseMarker,/turf/house/roof/top_right,/area)
"ba" = (/Building/Warper/Interior,/turf/castle_int/floor,/area)
"bb" = (/obj/map/DenseMarker,/turf/house/roof/top_left,/area)
"bc" = (/obj/map/DenseMarker,/turf/house/roof/corner/tr,/area)
"bd" = (/obj/map/cave_light,/obj/map/DenseMarker,/turf/house/roof/top,/area)
"be" = (/obj/map/DenseMarker,/turf/house/roof/corner/tl,/area)

(1,1,1) = {"
aaaaaaaaaaaaaaaaaaaaaaaaaaaaaaaaaaaaaaaaaaaaaaaaaaaaaaaaaaaaaaaaaaaaaaaaaaaaaaaaaaaaaaaaaaaaaaaaaaaaab
aaaaaaaaaaaaaaaaaaaaaaaaaaaaaaaaaaaaaaaaaaaaaaaaaaaaaaaaaaaaaaaaaaaaaaaaaaaaaaaaaaaaaaaaaaaaaaaaaaaaaa
aaaaaaaaaaaaaaaaaaaaaaaaaaaaaaaaaaaaaaaaaaaaaaaaaaaaaaaaaaaaaaaaaaaaaaaaaaaaaaaaaaaaaaaaaaaaaaaaaaaaaa
aaaaaaaaaaaaaaaaaaaaaaaaaaaaaaaaaaaaaaaaaaaaaaaaaaaaaaaaaaaaaaaaaaaaaaaaaaaaaaaaaaaaaaaaaaaaaaaaaaaaaa
aaaaaaaaaaaaaaaaaaaaaaaaaaaaaaaaaaaaaaaaaaaaaaaaaaaaaaaaaaaaaaaaaaaaaaaaaaaaaaaaaaaaaaaaaaaaaaaaaaaaaa
aaaaaaaaaaaaaaaaaaaaaaaaaaaaaaaaaaaaaaaaaaaaaaaaaaaaaaaaaaaaaaaaaaaaaaaaaaaaaaaaaaaaaaaaaaaaaaaaaaaaaa
aaaaaaaaaaaaaaaaaaaaaaaaaaaaaaaaaaaaaaaaaaaaaaaaaaaaaaaaaaaaaaaaaaaaaaaaaaaaaaaaaaaaaaaaaaaaaaaaaaaaaa
aaaaaaaaaaaaaaaaaaaaaaaaaaaaaaaaaaaaaaaaaaaaaaaaaaaaaaaaaaaaaaaaaaaaaaaaaaaaaaaaaaaaaaaaaaaaaaaaaaaaaa
aaaaaaaaaaaaaaaaaaaaaaaaaaaaaaaaaaaaaaaaaaaaaaaaaaaaaaaaaaaaaaaaaaaaaaaaaaaaaaaaaaaaaaaaaaaaaaaaaaaaaa
acacacacacacacacacacacacacacacacacacacacacacacacacacacacacacacacacacacaaaaaaaaaaaaaaaaaaaaaaaaaaaaaaaa
acaaaaaaaaaaaaaaaaaaaaaaadaeaeaeaeaeaeaeaeaeafaaaaaaaaaaaaaaaaaaaaaaacacacacacacacacacacacacacacacacac
acaaaaaaaaaaaaaaaaadaeaeagahahahahahahahahahaiaeaeafaaaaaaaaaaaaaaaaacaaaaaaaaaaaaaaaaaaaaaaaaaaaaaaac
acaaaaaaaaaaadaeaeagajajakahahahahahahahahahalajajaiaeaeafaaaaaaaaaaacadaeaeaeaeaeaeaeaeaeaeaeaeafaaac
acaaaaaaadaeagajajakahahamahahahahanahahahahaoahahalajajaiaeafaaaaaaacapajajajajajajajajajajajajaiafac
acaaadaeagajakahahamahahamahanahahahahahanahaoahahaoahahalajaiaeafaaacapahahahahahahahahahahahahalaqac
acadagajakahamahahamahahamahahahahahahahahahaoahahaoahahaoahalajaiafacapararararararararararararaoaqac
acapakahamahamahahamahahamahahahahahahahahahaoahahaoahahaoahaoahalaqacapasasasasasasasasasasasasataqac
acapamarauarauararauararauarararararararararatararatararatarataraoaqacapasasasasasasasasasasasasavaqac
acapauasasasasasasasasasasasasasasasasasasasasasasasasasasasasasataqacapasasasasasasasasasasasasawaxac
acapavasasasasasasasasasasasasasasasasasasasasasasasasasasasasasayaqacapazaAaBaCaCaCaCaCaCaCaCaCaqaaac
acaDaEasasasasasasasasasasasasasasasasasasasasasasasasasasasasasawaxacapaFaGaHaIaIaIaIaIaIaIaIaJaqaaac
acaaapaKaKaKaKaKaKaKaKaLasasasasasasasasasasasaMaKaKaKaKaKaKaKaKaqaaacapaFaGaHaNaNaNaNaNaNaNaNaOaqaaac
acaaapajajajajalajajajaPaKaKaKaKaKaKaKaKaKaKaKaQajajajakajajajajaqaaacapaRaGaSararararararararauaiafac
acaaapahahahahaoahahahalajajajalajajajakajajajakahahahamahahahahaqaaacapasasasasasasasasasasasasalaqac
acaaapahahahahaoahahahaoahahahaoahahahamahahahamahahahamahahahahaqaaacapasasasasasasasasasasasasaoaqac
acaaapararararatarararaoahahahaoahahahamahahahamarararauararararaqaaacapasasasasasasasasasasasasataqac
acaaapasasasasasasasasatarararatarararauarararauasasasasasasasasaqaaacapasasasasasasasasasasasasaTaUac
acaaapasasasasasasasasasasasasasasasasasasasasasasasasasasasasasaqaaacapasasasasasasasasasasasasawaxac
acaaapasasasasasasasasasasasasasasasasasasasasasasasasasasasasasaqaaacapasasasasasasasasasasasasaqaaac
acaaapasasasasasasasasasasasasasasasasasasasasasasasasasasasasasaqaaacaDaVaVaVaVaVaVaVaVaVaVaVaVaxaaac
acaaapasasasasasasasasasasasasasasasasasasasasasasasasasasasasasaqaaacacacacacacacacacacacacacacacacac
acadagasasasasasasasasasasasasasasasasasasasasasasasasasasasasasaiafacaaaaaaaaaaaaaaaaaaaaaaaaaaaaaaac
acapakasasasasasasasasasasasasasasasasasasasasasasasasasasasasasalaqacaaadaeaeaeaeaeaeaeaeaeaeaeaeafac
acapamasasasasasasasasasasasasasasasasasasasasasasasasasasasasasaoaqacadagajajajajajajajajajajajajaqac
acapauasasasasasasasasasasasasasasasasasasasasasasasasasasasasasataqacapakahahahahahahahahahahahahaqac
acaWaTasasasasasasasasasasasasasasasasasasasasasasasasasasasasasaXaUacapamararararararararararararaqac
acaDaEasasasasasasasasasasasasasasasasasasasasasasasasasasasasasawaxacapauasasasasasasasasasasasasaqac
acaaapasasasasasasasasasasasasasasasasasasasasasasasasasasasasasaqaaacapayasasasasasasasasasasasasaqac
acaaapasasasasasasasasasasasasasasasasasasasasasasasasasasasasasaqaaacaDaEasasasasasasasasasasasasaqac
acaaapasasasasasasasasasasasasasasasasasasasasasasasasasasasasasaqaaacaaapaCaCaCaCaCaCaCaCaCazaAaBaqac
acaaapasasasasasasasasasasasasasasasasasasasasasasasasasasasasasaqaaacaaapaIaIaIaIaIaIaIaIaJaFaGaHaqac
acaaapasasasasasasasasasasasasasasasasasasasasasasasasasasasasasaqaaacaaapaNaNaNaNaNaNaNaNaOaFaGaHaqac
acaaapasasasasasasasasasasasasasasasasasasasasasasasasasasasasasaqaaacadagararararararararauaRaGaSaqac
acaaapasasasasasasasasasasasasasasasasasasasasasasasasasasasasasaqaaacapakasasasasasasasasasasasasaqac
acaaapasasasasasasasasasasasasasasaYasasasasasasasasasasasasasasaqaaacapamasasasasasasasasasasasasaqac
acaaapasasasasasasasasasasasasasasasasasasasasasasasasasasasasasaqaaacapauasasasasasasasasasasasasaqac
acaaaDaVaEasasasasasasasasasasasasasasasasasasasasasasasasasawaVaxaaacaWaXasasasasasasasasasasasasaqac
acaaaaaaaDaVaVaVaVaVaVaVaVaVaVaEasasasawaVaVaVaVaVaVaVaVaVaVaxaaaaaaacaDaEasasasasasasasasasasasasaqac
acaaaaaaaaaaaaaaaaaaaaaaaaaaaaaDaZbabbaxaaaaaaaaaaaaaaaaaaaaaaaaaaaaacaaapasasasasasasasasasasasasaqac
acaaaaaaaaaaaaaaaaaaaaaaaaaaaaaabcbdbeaaaaaaaaaaaaaaaaaaaaaaaaaaaaaaacaaaDaVaVaVaVaVaVaVaVaVaVaVaVaxac
acacacacacacacacacacacacacacacacacacacacacacacacacacacacacacacacacacacacacacacacacacacacacacacacacacac
"}
