"aa" = (/turf,/area)
"ab" = (/obj/map/noDenseMarker,/turf/village/horizontal_roof_vdalion2/top_left,/area)
"ac" = (/obj/map/noDenseMarker,/turf/village/horizontal_roof_vdalion2/top_fill,/area)
"ad" = (/obj/map/noDenseMarker,/turf/village/horizontal_roof_vdalion2/top_right,/area)
"ae" = (/SmallPreview/End,/MapLimit,/turf,/area)
"af" = (/obj/map/noDenseMarker,/turf/village/horizontal_roof_vdalion2/left,/area)
"ag" = (/turf/village/horizontal_roof_vdalion2/fill,/area)
"ah" = (/obj/map/noDenseMarker,/turf/village/horizontal_roof_vdalion2/right,/area)
"ai" = (/turf/village/roof_vdalion2/left_3,/obj/map/noDenseMarker,/turf/village/horizontal_roof_vdalion2/bottom_left,/area)
"aj" = (/turf/village/wall_vdalion/bottom_left,/turf/village/horizontal_roof_vdalion2/bottom_fill,/area)
"ak" = (/turf/village/wall_vdalion/bottom,/turf/village/horizontal_roof_vdalion2/bottom_fill,/area)
"al" = (/turf/village/wall_vdalion/bottom_right,/turf/village/horizontal_roof_vdalion2/bottom_fill,/area)
"am" = (/turf/village/roof_vdalion2/right_3,/obj/map/noDenseMarker,/turf/village/horizontal_roof_vdalion2/bottom_right,/area)
"an" = (/turf/village/roof_vdalion2/left_3,/obj/map/noDenseMarker,/turf/village/horizontal_roof_vdalion2/top_fill,/area)
"ao" = (/turf/village/roof_vdalion2/left_2,/turf/village/horizontal_roof_vdalion2/top_fill,/area)
"ap" = (/turf/village/wall_vdalion/bottom_left,/area)
"aq" = (/turf/village/wall_vdalion/bottom,/obj/map/shop_int/window/dark,/turf/village/roof_vdalion2/center_3{layer = 7},/area)
"ar" = (/turf/village/wall_vdalion/bottom_right,/area)
"as" = (/turf/village/roof_vdalion2/right_2,/turf/village/horizontal_roof_vdalion2/top_fill,/area)
"at" = (/turf/village/roof_vdalion2/right_3,/obj/map/noDenseMarker,/turf/village/horizontal_roof_vdalion2/top_fill,/area)
"au" = (/turf/village/wall_vdalion/bottom_left,/turf/village/roof_vdalion2/left_3{layer = 7},/area)
"av" = (/turf/village/roof_vdalion2/center_2,/area)
"aw" = (/turf/village/wall_vdalion/bottom_right,/turf/village/roof_vdalion2/right_3{layer = 7},/area)
"ax" = (/turf/village/horizontal_roof_vdalion2/fill,/turf/village/roof_vdalion2/left_3{layer = 7},/area)
"ay" = (/turf/village/roof_vdalion2/left_2,/area)
"az" = (/turf/village/wall_vdalion/bottom,/turf/village/roof_vdalion2/center_1,/area)
"aA" = (/turf/village/roof_vdalion2/right_2,/area)
"aB" = (/turf/village/horizontal_roof_vdalion2/fill,/turf/village/roof_vdalion2/right_3{layer = 7},/area)
"aC" = (/turf/academy/rail/top_left,/area)
"aD" = (/turf/academy/rail/top,/turf/village/horizontal_roof_vdalion2/left,/area)
"aE" = (/turf/village/wall_vdalion/bottom,/turf/village/roof_vdalion2/left_1,/area)
"aF" = (/turf/village/wall_vdalion/bottom,/turf/village/roof_vdalion2/right_4,/turf/village/roof_vdalion2/left_4,/area)
"aG" = (/turf/village/wall_vdalion/bottom,/turf/village/roof_vdalion2/right_1,/area)
"aH" = (/turf/academy/rail/top,/turf/village/horizontal_roof_vdalion2/right,/area)
"aI" = (/turf/academy/rail/top_right,/area)
"aJ" = (/turf/academy/rail/top,/area)
"aK" = (/turf/academy/rail/left,/area)
"aL" = (/turf/academy/floor,/turf/village/horizontal_roof_vdalion2/bottom_left,/area)
"aM" = (/turf/village/wall_vdalion/bottom,/turf/village/horizontal_roof_vdalion2/bottom_fill,/turf/village/roof_vdalion2/left_5{layer = 7},/area)
"aN" = (/turf/village/wall_vdalion/bottom,/turf/village/roof_vdalion2/left_4,/area)
"aO" = (/turf/village/wall_vdalion/bottom,/area)
"aP" = (/turf/village/wall_vdalion/bottom,/turf/village/roof_vdalion2/right_4,/area)
"aQ" = (/turf/village/wall_vdalion/bottom,/turf/village/horizontal_roof_vdalion2/bottom_fill,/turf/village/roof_vdalion2/right_5{layer = 7},/area)
"aR" = (/turf/academy/floor,/turf/village/horizontal_roof_vdalion2/bottom_right,/area)
"aS" = (/turf/academy/rail/right,/area)
"aT" = (/turf/academy/floor,/area)
"aU" = (/obj/map/shop_int/window/dark,/turf/village/wall_vdalion/bottom,/area)
"aV" = (/turf/village/wall_vdalion/bottom,/turf/village/roof_vdalion2/left_6,/area)
"aW" = (/turf/village/wall_vdalion/bottom_left,/turf/village/roof_vdalion2/left_1,/area)
"aX" = (/turf/village/wall_vdalion/bottom,/turf/village/roof_vdalion2/right_6{layer = 7},/area)
"aY" = (/turf/village/wall_vdalion/bottom,/turf/village/roof_vdalion2/left_7{layer = 3},/area)
"aZ" = (/turf/village/wall_vdalion/bottom_left,/turf/village/roof_vdalion2/left_4,/area)
"ba" = (/turf/village/wall_vdalion/bottom_right,/turf/village/roof_vdalion2/right_4,/area)
"bb" = (/turf/village/wall_vdalion/bottom,/turf/village/roof_vdalion2/right_7{layer = 7},/area)
"bc" = (/turf/academy/rail/bottom_left,/area)
"bd" = (/turf/academy/rail/bottom,/area)
"be" = (/turf/academy/rail/bottom_right,/area)
"bf" = (/BuildingDetails{building_category = "Vdalion"; building_cost = 50000; building_desc = "A Church building."; building_guild = "Vdalion"; building_interior = 0; building_name = "V-Church"},/turf/village/wall_vdalion/bottom,/area)
"bg" = (/turf/village/wall_vdalion/top_left,/turf/city/wall/gap,/area)
"bh" = (/turf/village/wall_vdalion/top_middle,/area)
"bi" = (/turf/village/wall_vdalion/top_right,/turf/city/wall/gap/right,/area)
"bj" = (/turf/village/wall_vdalion/foundation_left,/area)
"bk" = (/obj/map/castle/gate/close,/turf/village/wall_vdalion/foundation_middle,/area)
"bl" = (/Building/Warper/Exterior,/turf/village/wall_vdalion/foundation_middle,/area)
"bm" = (/turf/village/wall_vdalion/foundation_middle,/area)
"bn" = (/turf/village/wall_vdalion/foundation_right,/area)
"bo" = (/turf/academy/floor,/turf/castle_int/stairs/top_left,/turf/castle_int/ledge/left_1,/area)
"bp" = (/turf/academy/floor,/turf/castle_int/stairs/top,/area)
"bq" = (/turf/academy/floor,/turf/castle_int/stairs/top_right,/turf/castle_int/ledge/right_1,/area)
"br" = (/turf/village/wall_vdalion/bottom_left,/turf/jianghu_house/shadow{density = 1},/area)
"bs" = (/turf/castle_int/stairs/left,/area)
"bt" = (/turf/castle_int/stairs/middle,/area)
"bu" = (/turf/castle_int/stairs/right,/area)
"bv" = (/turf/village/wall_vdalion/bottom_right,/turf/jianghu_house/shadow{density = 1},/area)
"bw" = (/SmallPreview/Start,/turf,/area)
"bx" = (/turf/village/road_brown/left,/turf/castle_int/stairs/bottom_left,/area)
"by" = (/turf/castle_int/stairs/bottom,/area)
"bz" = (/turf/castle_int/stairs/bottom_right,/area)

(1,1,1) = {"
aaaaaaaaaaaaaaaaaaabacacacadaaaaaaaaaaaaaaaaae
aaaaaaaaaaaaaaaaaaafagagagahaaaaaaaaaaaaaaaaaa
aaaaaaaaaaaaaaaaaaafagagagahaaaaaaaaaaaaaaaaaa
aaaaaaaaaaaaaaaaaaaiajakalamaaaaaaaaaaaaaaaaaa
aaaaaaaaabacacacanaoapaqarasatacacacadaaaaaaaa
aaaaaaaaafagagagagagauavawagagagagagahaaaaaaaa
aaaaaaaaafagagagagaxayazaAaBagagagagahaaaaaaaa
aaaaaaaCaDagagagaxayaEaFaGaAaBagagagaHaIaaaaaa
aaaaaaaKaLajakaMayaEaNaOaPaGaAaQakalaRaSaaaaaa
aaaCaJaKaTapaUaVaWaNaOaOaOaPaGaXaUaraTaSaJaIaa
aaaKaTaKaTapaOaYaZaUaOaOaOaUbabbaOaraTaSaTaSaa
aaaKaTaKaTaTaTaTapaOaOaOaOaOaraTaTaTaTaSaTaSaa
aaaKaTbcbdbdbdbdbdbdbdbdbdbdbdbdbdbdbdbeaTaSaa
aabcbdapaOaOaOaOaraOaObfaOaOapaOaOaOaOarbdbeaa
aaapaOapaOaOaOaOarbgbhbhbhbiapaOaOaOaOaraOaraa
aaapaOapaUaOaOaUarbjbkblbmbnapaUaOaOaUaraOaraa
aabjbmapaOaOaOaOaraTaTaTaTaTapaOaOaOaOarbmbnaa
aaaaaabjbmbmaKaTaTaTaTaTaTaTaTaTaSbmbmbnaaaaaa
aaaaaaaaaaaabcbobpbqbdbdbdbobpbqbeaaaaaaaaaaaa
aaaaaaaaaaaabrbsbtbubraObvbsbtbubvaaaaaaaaaaaa
bwaaaaaaaaaaaabxbybzaaaaaabxbybzaaaaaaaaaaaaaa
"}
