"aa" = (/turf/void,/area)
"ab" = (/obj/map/viewBlock,/turf/void,/area)
"ac" = (/turf/house/roof/corner/br,/area)
"ad" = (/turf/house/roof/bottom,/area)
"ae" = (/turf/house/roof/corner/bl,/area)
"af" = (/turf/house/roof/right,/area)
"ag" = (/MapLimit,/turf/void,/area)
"ah" = (/turf/village/wall_vdalion/bottom,/turf/jianghu_house/shadow{density = 1},/area)
"ai" = (/turf/village/wall_vdalion/bottom,/turf/jianghu_house/shadow{density = 1},/turf/village/vdalion_extra/windowbig_4,/area)
"aj" = (/turf/house/roof/left,/area)
"ak" = (/obj/generic_shadow/white{alpha = 50; color = "black"; icon_state = "full"; layer = 4},/turf/village/wall_vdalion/bottom,/area)
"al" = (/turf/village/wall_vdalion/bottom,/area)
"am" = (/turf/village/wall_vdalion/bottom,/obj/generic_shadow/white{alpha = 50; color = "black"; icon_state = "full"; layer = 4},/turf/jianghu_house/shadow{density = 1},/area)
"an" = (/obj/generic_shadow/white{alpha = 50; color = "black"; icon_state = "full"; layer = 4},/turf/village/wall_vdalion/foundation_middle,/area)
"ao" = (/turf/village/wall_vdalion/foundation_middle,/area)
"ap" = (/obj/generic_shadow/white{alpha = 50; color = "black"; icon_state = "full"; layer = 4},/obj/generic_shadow/white{alpha = 75; color = "black"; icon_state = "top"},/turf/inn/floor,/area)
"aq" = (/obj/generic_shadow/white{alpha = 75; color = "black"; icon_state = "top"},/turf/inn/floor,/area)
"ar" = (/obj/generic_shadow/white{alpha = 50; color = "black"; icon_state = "full"; layer = 4},/turf/inn/floor,/area)
"as" = (/turf/inn/floor,/area)
"at" = (/turf/house/roof/corner/tr,/area)
"au" = (/turf/house/roof/top,/area)
"av" = (/obj/map/DenseMarker,/turf/house/roof/top_right,/area)
"aw" = (/Building/Warper/Dynamic{dynamic_id = "VMedium House C_2"},/turf/inn/floor,/area)
"ax" = (/obj/map/DenseMarker,/turf/house/roof/top_left,/area)
"ay" = (/turf/house/roof/corner/tl,/area)
"az" = (/Building/Warper/Dynamic{dynamic_id = "VMedium House C_3"},/turf/inn/floor,/area)
"aA" = (/obj/map/DenseMarker,/turf/house/roof/corner/tr,/area)
"aB" = (/obj/map/cave_light,/obj/map/DenseMarker,/turf/house/roof/top,/area)
"aC" = (/obj/map/DenseMarker,/turf/house/roof/corner/tl,/area)
"aD" = (/turf/house/roof/bottom_left,/area)
"aE" = (/turf/house/roof/bottom_right,/area)
"aF" = (/turf/village/wall_vdalion/bottom,/turf/village/vdalion_extra/door_top,/area)
"aG" = (/turf/village/wall_vdalion/bottom_left,/turf/jianghu_house/shadow{density = 1},/area)
"aH" = (/turf/village/wall_vdalion/bottom_right,/turf/jianghu_house/shadow{density = 1},/area)
"aI" = (/Building/Warper/Dynamic{dynamic_id = "VMedium House C_2"},/turf/village/vdalion_extra/door_bottom,/area)
"aJ" = (/turf/village/wall_vdalion/bottom_left,/area)
"aK" = (/turf/village/wall_vdalion/bottom_right,/area)
"aL" = (/Building/Warper/Dynamic{dynamic_id = "VMedium House C_3"},/turf/village/vdalion_extra/door_bottom,/area)
"aM" = (/turf/village/wall_vdalion/foundation_left,/area)
"aN" = (/turf/village/wall_vdalion/foundation_right,/Region{desc = "Osrona's merchant district, Caelfall has a high number of shops and large homes for those more well off than the majority of the population. Within the middle is a large park with a small body of water within it's center. The jail, as well as the City Watch's headquarters is also known to be found here."; name = "Caelfall"})
"aO" = (/obj/generic_shadow/white{alpha = 50; color = "black"; icon_state = "tl_corner"; name = "house shadow corner"},/obj/generic_shadow/white{alpha = 75; color = "black"; icon_state = "top"},/turf/inn/floor,/area)
"aP" = (/turf/house/roof/top_right,/area)
"aQ" = (/obj/map/DenseMarker,/turf/shop_int/stairs/middle,/area)
"aR" = (/Building/Warper/Dynamic{dynamic_id = "VMedium House C_1"},/turf/shop_int/stairs/middle,/area)
"aS" = (/turf/house/roof/top_left,/area)
"aT" = (/turf/castle_int/roof/middle,/area)
"aU" = (/obj/map/DenseMarker,/turf/house/roof/bottom,/area)
"aV" = (/obj/map/cave_light,/obj/map/DenseMarker,/turf/house/roof/bottom,/area)
"aW" = (/turf/shop_int/stairs/middle,/area)
"aX" = (/Building/Warper/Dynamic{dynamic_id = "VMedium House C_4"},/turf/village/vdalion_extra/door_bottom,/area)
"aY" = (/turf/village/wall_vdalion/bottom,/obj/map/cave_light,/turf/village/vdalion_extra/windowbig_3,/area)
"aZ" = (/Building/Warper/Dynamic{dynamic_id = "VMedium House C_4"},/turf/inn/floor,/area)
"ba" = (/obj/generic_shadow/white{alpha = 50; color = "black"; icon_state = "full"; layer = 4},/turf/village/wall_vdalion/bottom_right,/area)
"bb" = (/obj/generic_shadow/white{alpha = 50; color = "black"; icon_state = "full"; layer = 4},/turf/village/wall_vdalion/foundation_right,/Region{desc = "Osrona's merchant district, Caelfall has a high number of shops and large homes for those more well off than the majority of the population. Within the middle is a large park with a small body of water within it's center. The jail, as well as the City Watch's headquarters is also known to be found here."; name = "Caelfall"})
"bc" = (/turf/village/wall_vdalion/bottom_right,/obj/generic_shadow/white{alpha = 50; color = "black"; icon_state = "full"; layer = 4},/turf/jianghu_house/shadow{density = 1},/area)
"bd" = (/Building/Warper/Interior,/turf/inn/floor,/area)
"be" = (/BuildingDetails{building_category = "Vdalion"; building_cost = 50000; building_desc = "A modest building with 3 rooms."; building_guild = "Vdalion"; building_interior = 1; building_name = "V-Medium House C"; building_settlement_only = 1},/turf/inn/floor,/area)

(1,1,1) = {"
aaaaaaaaaaaaaaaaaaaaaaaaaaaaaaaaaaaaaaaaaaaaaaaaaaaaaaaaaaaaaaaaaaaaaaaaaaaaaaaaaaaaaaaaaaaaaaaaaaaaag
aaaaaaaaaaaaaaaaaaaaaaaaaaaaaaaaaaaaaaaaaaaaaaaaaaaaaaaaaaaaaaaaaaaaaaaaaaaaaaaaaaaaaaaaaaaaaaaaaaaaaa
aaaaaaaaaaaaaaaaaaaaaaaaaaaaaaaaaaaaaaaaaaaaaaaaaaabababababababababababababababababaaaaaaaaaaaaaaaaaa
aaaaaaaaaaaaaaaaaaaaaaaaaaaaaaaaaaaaaaaaaaaaaaaaaaabacadadadadadadadadadadadadadaeabaaaaaaaaaaaaaaaaaa
aaaaaaaaaaaaaaaaaaaaaaaaaaaaaaaaaaaaaaaaaaaaaaaaaaabafamahaiahahahahahahahaiahahajabaaaaaaaaaaaaaaaaaa
aaaaaaaaaaaaaaaaaaaaaaaaaaaaaaaaaaaaaaaaaaaaaaaaaaabafakalaYalalalalalalalaYalalajabaaaaaaaaaaaaaaaaaa
aaaaaaaaaaaaaaaaaaaaaaaaaaaaaaaaaaaaaaaaaaaaaaaaaaabafanaoaoaoaoaoaoaoaoaoaoaoaoajabaaaaaaaaaaaaaaaaaa
aaaaaaaaaaaaaaaaaaaaaaaaaaaaaaaaaaaaaaaaaaaaaaaaaaabafapaqaqaqaqaqaqaqaqaqaqaqaqajabaaaaaaaaaaaaaaaaaa
aaaaaaaaaaaaaaaaaaaaaaaaaaaaaaaaaaaaaaaaaaaaaaaaaaabafarasasasasasasasasasasasasajabaaaaaaaaaaaaaaaaaa
aaaaaaaaaaaaaaaaaaaaaaaaaaaaaaaaaaaaaaaaaaaaaaaaaaabafarasasasasasasasasasasasasajabaaaaaaaaaaaaaaaaaa
aaaaaaaaaaaaaaaaaaaaaaaaaaaaaaaaaaaaaaaaaaaaaaaaaaabafarasasasasasasasasasasasasajabaaaaaaaaaaaaaaaaaa
aaaaaaaaaaaaaaaaaaaaaaaaaaaaaaaaaaaaaaaaaaaaaaaaaaabafarasasasasasasasasasasasasajabaaaaaaaaaaaaaaaaaa
aaaaaaaaaaaaaaaaaaaaaaaaaaaaaaaaaaaaaaaaaaaaaaaaaaabafarasasasasasasasasasasasasajabaaaaaaaaaaaaaaaaaa
aaaaaaaaaaaaaaaaaaaaaaaaaaaaaaaaaaaaaaaaaaaaaaaaaaabafarasasasasasasasasasasasasajabaaaaaaaaaaaaaaaaaa
aaabababababababababababababababababababababababaaabafarasasasasasasasasasasasasajabaaaaaaaaaaaaaaaaaa
aaabacadadadadadaeacadadadadadaeacadadadadadaeabaaabafarasasasasasasasasasasasasajabaaaaaaaaaaaaaaaaaa
aaabafamahahahahaDaEamahaiahahaDaEamahahahahajabaaabatauauauauauavawaxauauauauauayabaaaaaaaaaaaaaaaaaa
aaabafakalaFalalaGaHakalaYalalaGaHakalaFalalajabaaabaaaaaaaaaaaaaAaBaCaaaaaaaaaaaaabaaaaaaaaaaaaaaaaaa
aaabafanaoaIaoaoaJaKanaoaoaoaoaJaKanaoaLaoaoajabaaabababababababababababababababababaaaaaaaaaaaaaaaaaa
aaabafapaqaqaqaqaMaNaOaqaqaqaqaMaNaOaqaqaqaqajabaaabacadadadadadadadadadadadadadaeabaaaaaaaaaaaaaaaaaa
aaabafarasasasasasasasasasasasasasasasasasasajabaaabafamahaiahahahahahahahaiahahajabaaaaaaaaaaaaaaaaaa
aaabafarasasasasasasasasasasasasasasasasasasajabaaabafakalaYalalalalalalalaYalalajabaaaaaaaaaaaaaaaaaa
aaabafarasasasasasasasasasasasasasasasasasasajabaaabafanaoaoaoaoaoaoaoaoaoaoaoaoajabaaaaaaaaaaaaaaaaaa
aaabafarasasasasasasasasasasasasasasasasasasajabaaabafapaqaqaqaqaqaqaqaqaqaqaqaqajabaaaaaaaaaaaaaaaaaa
aaabatauauauauauauauaPaQaRaQaSauauauauauauauayabaaabafarasasasasasasasasasasasasajabaaaaaaaaaaaaaaaaaa
aaabaaaaaTaTaTaTaTaTatauauauayaTaTaTaTaTaTaTaTabaaabafarasasasasasasasasasasasasajabaaaaaaaaaaaaaaaaaa
aaabaaaaaTaTaTaTaTaTaTaTaTaTaTaTaTaTaTaaaaaaaaabaaabafarasasasasasasasasasasasasajabaaaaaaaaaaaaaaaaaa
ababababababababababababababababababababababababababafarasasasasasasasasasasasasajabaaaaaaaaaaaaaaaaaa
abaaacadadadadadadadaeacaUaVaUaeacadadadadadadadaeabafarasasasasasasasasasasasasajabaaaaaaaaaaaaaaaaaa
abaaafamahahaiahahahaDaEaQaRaQaDaEamahahahahahahajabafarasasasasasasasasasasasasajabaaaaaaaaaaaaaaaaaa
abaaafakalalaYalalalaGaHaWaWaWaGaHakalalaFalalalajabafarasasasasasasasasasasasasajabaaaaaaaaaaaaaaaaaa
abaaafanaoaoaoaoaoaoaJaKaWaWaWaJaKanaoaoaXaoaoaoajabafarasasasasasasasasasasasasajabaaaaaaaaaaaaaaaaaa
abaaafapaqaqaqaqaqaqaMaNaWaWaWaMaNaOaqaqaqaqaqaqajabatauauauauauavazaxauauauauauayabaaaaaaaaaaaaaaaaaa
abaaafarasasasasasasasasasasasasasasasasasasasasajabaaaaaaaaaaaaaAaBaCaaaaaaaaaaaaabaaaaaaaaaaaaaaaaaa
abaaafarasasasasasasasasasasasasasasasasasasasasajabababababababababababababababababaaaaaaaaaaaaaaaaaa
abaaafarasasasasasasasasasasasasasasasasasasasasajabacadadadadadadadadadadadadadaeabaaaaaaaaaaaaaaaaaa
abaaafarasasasasasasasasasasasasasasasasasasasasajabafamahaiahahahahahahahaiahahajabaaaaaaaaaaaaaaaaaa
abaaafarasasasasasasasasasasasasasasasasasasasasajabafakalaYalalalalalalalaYalalajabaaaaaaaaaaaaaaaaaa
abaaafarasasasasasasasasasasasasasasasasasasasasajabafanaoaoaoaoaoaoaoaoaoaoaoaoajabaaaaaaaaaaaaaaaaaa
abaaafarasasasasasasasasasasasasasasasasasasasasajabafapaqaqaqaqaqaqaqaqaqaqaqaqajabaaaaaaaaaaaaaaaaaa
abaaatauauauauauauaPasasasasasasasaSauauauauauauayabafarasasasasasasasasasasasasajabaaaaaaaaaaaaaaaaaa
abaaaaaaaaaaaaaaacaEasasasasasasasaDaeaaaaaaaaaaaaabafarasasasasasasasasasasasasajabaaaaaaaaaaaaaaaaaa
abaaaaaaaaaaaaaaafbcasasasasasasasaGajaaaaaaaaaaaaabafarasasasasasasasasasasasasajabaaaaaaaaaaaaaaaaaa
abaaaaaaaaaaaaaaafbaasasasasasasasaJajaaaaaaaaaaaaabafarasasasasasasasasasasasasajabaaaaaaaaaaaaaaaaaa
abaaaaaaaaaaaaaaafbbasasasasasasasaMajaaaaaaaaaaaaabafarasasasasasasasasasasasasajabaaaaaaaaaaaaaaaaaa
abaaaaaaaaaaaaaaafarasasasasasasasasajaaaaaaaaaaaaabafarasasasasasasasasasasasasajabaaaaaaaaaaaaaaaaaa
abaaaaaaaaaaaaaaafarasasasbeasasasasajaaaaaaaaaaaaabafarasasasasasasasasasasasasajabaaaaaaaaaaaaaaaaaa
abaaaaaaaaaaaaaaafarasasasasasasasasajaaaaaaaaaaaaabafarasasasasasasasasasasasasajabaaaaaaaaaaaaaaaaaa
abaaaaaaaaaaaaaaatauauauavbdaxauauauayaaaaaaaaaaaaabatauauauauauavaZaxauauauauauayabaaaaaaaaaaaaaaaaaa
abaaaaaaaaaaaaaaaaaaaaaaaAaBaCaaaaaaaaaaaaaaaaaaaaabaaaaaaaaaaaaaAaBaCaaaaaaaaaaaaabaaaaaaaaaaaaaaaaaa
ababababababababababababababababababababababababababababababababababababababababababaaaaaaaaaaaaaaaaaa
"}
