"a" = (/turf/void,/area)
"b" = (/obj/map/viewBlock,/turf/void,/area)
"c" = (/turf/house/roof/corner/br,/area)
"d" = (/turf/house/roof/bottom,/area)
"e" = (/turf/house/roof/corner/bl,/area)
"f" = (/turf/house/roof/right,/area)
"g" = (/MapLimit,/turf/void,/area)
"h" = (/turf/village/wall_vdalion/bottom,/turf/jianghu_house/shadow{density = 1},/area)
"i" = (/turf/village/wall_vdalion/bottom,/turf/jianghu_house/shadow{density = 1},/turf/village/vdalion_extra/windowbig_4,/area)
"j" = (/turf/house/roof/left,/area)
"k" = (/obj/generic_shadow/white{alpha = 50; color = "black"; icon_state = "full"; layer = 4},/turf/village/wall_vdalion/bottom,/area)
"l" = (/turf/village/wall_vdalion/bottom,/area)
"m" = (/turf/village/wall_vdalion/bottom,/obj/generic_shadow/white{alpha = 50; color = "black"; icon_state = "full"; layer = 4},/turf/jianghu_house/shadow{density = 1},/area)
"n" = (/obj/generic_shadow/white{alpha = 50; color = "black"; icon_state = "full"; layer = 4},/turf/village/wall_vdalion/foundation_middle,/area)
"o" = (/turf/village/wall_vdalion/foundation_middle,/area)
"p" = (/obj/generic_shadow/white{alpha = 50; color = "black"; icon_state = "full"; layer = 4},/obj/generic_shadow/white{alpha = 75; color = "black"; icon_state = "top"},/turf/inn/floor,/area)
"q" = (/obj/generic_shadow/white{alpha = 75; color = "black"; icon_state = "top"},/turf/inn/floor,/area)
"r" = (/obj/generic_shadow/white{alpha = 50; color = "black"; icon_state = "full"; layer = 4},/turf/inn/floor,/area)
"s" = (/turf/inn/floor,/area)
"t" = (/turf/house/roof/corner/tr,/area)
"u" = (/turf/house/roof/top,/area)
"v" = (/obj/map/DenseMarker,/turf/house/roof/top_right,/area)
"w" = (/Building/Warper/Dynamic{dynamic_id = "vdalionG_room1"},/turf/inn/floor,/area)
"x" = (/obj/map/DenseMarker,/turf/house/roof/top_left,/area)
"y" = (/turf/house/roof/corner/tl,/area)
"z" = (/obj/map/DenseMarker,/turf/house/roof/corner/tr,/area)
"A" = (/obj/map/cave_light,/obj/map/DenseMarker,/turf/house/roof/top,/area)
"B" = (/obj/map/DenseMarker,/turf/house/roof/corner/tl,/area)
"C" = (/obj/map/DenseMarker,/turf/house/roof/bottom,/area)
"D" = (/obj/map/cave_light,/obj/map/DenseMarker,/turf/house/roof/bottom,/area)
"E" = (/obj/generic_shadow/white{alpha = 50; color = "black"; icon_state = "full"; layer = 4},/obj/map/DenseMarker,/turf/shop_int/stairs/middle,/area)
"F" = (/Building/Warper/Dynamic{dynamic_id = "vdalionG_room1"},/turf/shop_int/stairs/middle,/area)
"G" = (/obj/map/DenseMarker,/turf/shop_int/stairs/middle,/area)
"H" = (/turf/house/roof/bottom_left,/area)
"I" = (/turf/house/roof/bottom_right,/area)
"J" = (/obj/generic_shadow/white{alpha = 50; color = "black"; icon_state = "full"; layer = 4},/turf/shop_int/stairs/middle,/area)
"K" = (/turf/shop_int/stairs/middle,/area)
"L" = (/turf/village/wall_vdalion/bottom_left,/turf/jianghu_house/shadow{density = 1},/area)
"M" = (/turf/village/wall_vdalion/bottom_right,/turf/jianghu_house/shadow{density = 1},/area)
"N" = (/turf/village/wall_vdalion/bottom,/turf/village/vdalion_extra/door_top,/area)
"O" = (/turf/village/wall_vdalion/bottom_left,/area)
"P" = (/turf/village/wall_vdalion/bottom_right,/area)
"Q" = (/turf/village/wall_vdalion/bottom,/obj/map/cave_light,/turf/village/vdalion_extra/windowbig_3,/area)
"R" = (/turf/village/wall_vdalion/foundation_left,/area)
"S" = (/turf/village/wall_vdalion/foundation_right,/Region{desc = "Osrona's merchant district, Caelfall has a high number of shops and large homes for those more well off than the majority of the population. Within the middle is a large park with a small body of water within it's center. The jail, as well as the City Watch's headquarters is also known to be found here."; name = "Caelfall"})
"T" = (/obj/generic_shadow/white{alpha = 50; color = "black"; icon_state = "tl_corner"},/obj/generic_shadow/white{alpha = 75; color = "black"; icon_state = "top"},/turf/inn/floor,/area)
"U" = (/turf/house/roof/top_left,/area)
"V" = (/turf/house/roof/top_right,/area)
"W" = (/Building/Warper/Dynamic{dynamic_id = "vdalionG_room2"},/obj/map/noDenseMarker,/turf/village/vdalion_extra/door_bottom,/area)
"X" = (/Building/Warper/Interior,/turf/inn/floor,/area)
"Y" = (/Building/Warper/Dynamic{dynamic_id = "vdalionG_room2"},/turf/inn/floor,/area)
"Z" = (/BuildingDetails{building_category = "Vdalion"; building_cost = 50000; building_desc = "A modest building with 3 rooms."; building_guild = "Vdalion"; building_interior = 1; building_name = "V-Medium House A"; building_settlement_only = 1},/turf/inn/floor,/area)

(1,1,1) = {"
aaaaaaaaaaaaaaaaaaaaaaaaaaaaaaaaaaaaaaaaaaaaaaaaaag
aaaaaaaaaaaaaaaaaaaaaaaaaaaaaaaaaaaaaaaaaaaaaaaaaaa
aaaaaaaaaaaaaaaaaaaaaaaaaaaaaaaaaaaaaaaaaaaaaaaaaaa
aaaaaaaaaaaaaaaaaaaaaaaaaaaaaaaaaaaaaaaaaaaaaaaaaaa
aaaaaaaaaaaaaaaaaaaaaaaaaaaaaaaaaaaaaaaaaaaaaaaaaaa
aaaaaaaaaaaaaaaaaaaaaaaaaaaaaaaaaaaaaaaaaaaaaaaaaaa
aaaaaaaaaaaaaaaaaaaaaaaaaaaaaaaaaaaaaaaaaaaaaaaaaaa
aaaaaaaaaaaaaaaaaaaaaaaaaaaaaaaaaaaaaaaaaaaaaaaaaaa
aaaaaaaaaaaaaaaaaaaaaaaaaaaaaaaaaaaaaaaaaaaaaaaaaaa
aabbbbbbbbbbbbbbbbbbbaaaaaaaaaaaaaaaaaaaaaaaaaaaaaa
aabaaaaaaaaaaaaaaaaabaaaaaaaaaaaaaaaaaaaaaaaaaaaaaa
aabacdddddddddddddeabaaaaaaaaaaaaaaaaaaaaaaaaaaaaaa
aabafmhihhhhhhhihhjabaaaaaaaaaaaaaaaaaaaaaaaaaaaaaa
aabafklQlllllllQlljabaaaaaaaaaaaaaaaaaaaaaaaaaaaaaa
aabafnoooooooooooojabaaaaaaaaaaaaaaaaaaaaaaaaaaaaaa
aabafpqqqqqqqqqqqqjabaaaaaaaaaaaaaaaaaaaaaaaaaaaaaa
aabafrssssssssssssjabaaaaaaaaaaaaaaaaaaaaaaaaaaaaaa
aabafrssssssssssssjabaaaaaaaaaaaaaaaaaaaaaaaaaaaaaa
aabafrssssssssssssjabaaaaaaaaaaaaaaaaaaaaaaaaaaaaaa
aabafrssssssssssssjabaaaaaaaaaaaaaaaaaaaaaaaaaaaaaa
aabafrssssssssssssjabaaaaaaaaaaaaaaaaaaaaaaaaaaaaaa
aabafrssssssssssssjabaaaaaaaaaaaaaaaaaaaaaaaaaaaaaa
aabafrssssssssssssjabaaaaaaaaaaaaaaaaaaaaaaaaaaaaaa
aabafrssssssssssssjabaaaaaaaaaaaaaaaaaaaaaaaaaaaaaa
aabatuuuuuvwxuuuuuyabaaaaaaaaaaaaaaaaaaaaaaaaaaaaaa
aabaaaaaaazABaaaaaaabaaaaaaaaaaaaaaaaaaaaaaaaaaaaaa
aabaaaaaaaaaaaaaaaaabaaaaaaaaaaaaaaaaaaaaaaaaaaaaaa
bbbbbbbbbbbbbbbbbbbbbbbbaaaaaaaaaaaaaaaaaaaaaaaaaaa
bacCDCecdddddecddddddeabaaaaaaaaaaaaaaaaaaaaaaaaaaa
bafEFGHImhhhhHImhhihhjabaaaaaaaaaaaaaaaaaaaaaaaaaaa
bafJKKLMklNllLMkllQlljabaaaaaaaaaaaaaaaaaaaaaaaaaaa
bafJKKOPnoWooOPnooooojabaaaaaaaaaaaaaaaaaaaaaaaaaaa
bafJKKRSTqqqqRSTqqqqqjabaaabbbbbbbbbbbbbbbbbbbaaaaa
bafrsssssssssssssssssjabaaabaaaaaaaaaaaaaaaaabaaaaa
bafrsssssssssssssssssjabaaabacdddddddddddddeabaaaaa
bafrsssssssssssssssssjabaaabafmhihhhhhhhihhjabaaaaa
bafrsssssssssssssssssjabaaabafklQlllllllQlljabaaaaa
bafrsssssssssssssssssjabaaabafnoooooooooooojabaaaaa
bafrsssssssssssssssssjabaaabafpqqqqqqqqqqqqjabaaaaa
bafrsssssssssssssssssjabaaabafrssssssssssssjabaaaaa
bafrsssssssssssssssssjabaaabafrssssssssssssjabaaaaa
bafrsssssssssUVssssssjabaaabafrssssssssssssjabaaaaa
bafrsssssssssjtuuuuuuyabaaabafrssssssssssssjabaaaaa
bafrsssssssssjaaaaaaaaabaaabafrssssssssssssjabaaaaa
bafrsssssssssjaaaaaaaaabaaabafrssssssssssssjabaaaaa
bafrsssZsssssjaaaaaaaaabaaabafrssssssssssssjabaaaaa
bafrsssssssssjaaaaaaaaabaaabafrssssssssssssjabaaaaa
batuuuvXxuuuuyaaaaaaaaabaaabatuuuuuvYxuuuuuyabaaaaa
baaaaazABaaaaaaaaaaaaaabaaabaaaaaaazABaaaaaaabaaaaa
baaaaaaaaaaaaaaaaaaaaaabaaabaaaaaaaaaaaaaaaaabaaaaa
bbbbbbbbbbbbbbbbbbbbbbbbaaabbbbbbbbbbbbbbbbbbbaaaaa
"}
