"aa" = (/turf/void,/area)
"ab" = (/turf,/area)
"ac" = (/obj/map/noDenseMarker,/turf/village/roof_vdalion2/center_3,/area)
"ad" = (/obj/map/noDenseMarker,/turf/village/roof_vdalion2/left_3,/area)
"ae" = (/obj/map/noDenseMarker,/turf/village/roof_vdalion2/center_2,/area)
"af" = (/obj/map/noDenseMarker,/turf/village/roof_vdalion2/right_3,/area)
"ag" = (/turf/village/roof_vdalion2/left_2,/area)
"ah" = (/turf/village/roof_vdalion2/center_2,/area)
"ai" = (/turf/village/roof_vdalion2/right_2,/area)
"aj" = (/obj/map/noDenseMarker,/turf/village/roof_vdalion2/left_5{layer = 7},/area)
"ak" = (/turf/village/wall_vdalion/bottom,/turf/village/roof_vdalion2/center_1,/area)
"al" = (/obj/map/noDenseMarker,/turf/village/roof_vdalion2/right_5,/area)
"am" = (/obj/map/noDenseMarker,/turf/village/roof_vdalion2/left_6,/area)
"an" = (/turf/village/wall_vdalion/bottom,/turf/village/roof_vdalion2/left_1,/area)
"ao" = (/turf/village/wall_vdalion/bottom,/turf/village/roof_vdalion2/left_4,/turf/village/roof_vdalion2/right_4,/area)
"ap" = (/turf/village/wall_vdalion/bottom,/turf/village/roof_vdalion2/right_1,/area)
"aq" = (/SmallPreview/End,/turf,/area)
"ar" = (/obj/map/noDenseMarker,/turf/village/horizontal_roof_vdalion2/top_fill,/area)
"as" = (/obj/map/noDenseMarker,/turf/village/horizontal_roof_vdalion2/top_right,/area)
"at" = (/turf/inn/rail/middle,/turf/inn/rail/left,/area)
"au" = (/turf/inn/rail/middle,/area)
"av" = (/turf/inn/rail/middle,/turf/village/roof_vdalion2/left_6,/area)
"aw" = (/turf/village/wall_vdalion/bottom,/turf/village/roof_vdalion2/left_4,/area)
"ax" = (/turf/village/wall_vdalion/bottom,/turf/village/vdalion_extra/window_2,/area)
"ay" = (/turf/village/wall_vdalion/bottom,/turf/village/roof_vdalion2/right_4,/area)
"az" = (/turf/village/horizontal_roof_vdalion2/fill,/turf/village/roof_vdalion2/right_6{layer = 7; name = "right 6_1"},/area)
"aA" = (/turf/village/horizontal_roof_vdalion2/fill,/area)
"aB" = (/obj/map/noDenseMarker,/turf/village/horizontal_roof_vdalion2/right,/area)
"aC" = (/turf/inn/floor,/turf/inn/rail/left,/Region{desc = "Osrona's merchant district, Caelfall has a high number of shops and large homes for those more well off than the majority of the population. Within the middle is a large park with a small body of water within it's center. The jail, as well as the City Watch's headquarters is also known to be found here."; name = "Caelfall"})
"aD" = (/turf/inn/floor,/Region{desc = "Osrona's merchant district, Caelfall has a high number of shops and large homes for those more well off than the majority of the population. Within the middle is a large park with a small body of water within it's center. The jail, as well as the City Watch's headquarters is also known to be found here."; name = "Caelfall"})
"aE" = (/MapLimit,/turf/void,/area)
"aF" = (/turf/village/wall_vdalion/bottom_left,/turf/village/roof_vdalion2/left_1,/area)
"aG" = (/turf/village/wall_vdalion/bottom,/area)
"aH" = (/turf/village/wall_vdalion/bottom,/turf/village/vdalion_extra/windowbig_5,/area)
"aI" = (/turf/village/wall_vdalion/bottom_right,/turf/village/roof_vdalion2/right_1,/area)
"aJ" = (/turf/village/horizontal_roof_vdalion2/top_fill,/obj/map/noDenseMarker,/turf/village/roof_vdalion2/right_6{layer = 7; name = "right 6_1"},/area)
"aK" = (/turf/village/wall_vdalion/bottom_left,/turf/village/roof_vdalion2/left_4,/area)
"aL" = (/turf/village/wall_vdalion/bottom,/turf/village/horizontal_roof_vdalion2/top_left,/area)
"aM" = (/turf/village/wall_vdalion/bottom,/turf/village/horizontal_roof_vdalion2/top_fill,/area)
"aN" = (/turf/village/wall_vdalion/bottom_right,/turf/village/roof_vdalion2/right_4,/turf/village/horizontal_roof_vdalion2/top_fill,/area)
"aO" = (/turf/village/horizontal_roof_vdalion2/fill,/turf/village/roof_vdalion2/right_7{layer = 7; name = "right 7_1"},/area)
"aP" = (/turf/village/wall_vdalion/bottom_left,/area)
"aQ" = (/turf/village/wall_vdalion/bottom,/turf/village/horizontal_roof_vdalion2/left,/area)
"aR" = (/turf/village/wall_vdalion/foundation_left,/area)
"aS" = (/turf/village/wall_vdalion/foundation_middle,/turf/village/horizontal_roof_vdalion2/bottom_left,/area)
"aT" = (/turf/village/wall_vdalion/bottom_left,/turf/village/horizontal_roof_vdalion2/bottom_fill,/area)
"aU" = (/turf/village/wall_vdalion/bottom,/turf/village/horizontal_roof_vdalion2/bottom_fill,/turf/village/vdalion_extra/windowbig_4,/area)
"aV" = (/turf/village/wall_vdalion/bottom,/turf/village/horizontal_roof_vdalion2/bottom_fill,/area)
"aW" = (/turf/inn/floor,/obj/map/noDenseMarker,/turf/village/roof_vdalion2/left_6,/Region{desc = "Osrona's merchant district, Caelfall has a high number of shops and large homes for those more well off than the majority of the population. Within the middle is a large park with a small body of water within it's center. The jail, as well as the City Watch's headquarters is also known to be found here."; name = "Caelfall"})
"aX" = (/turf/village/wall_vdalion/bottom_right,/turf/village/horizontal_roof_vdalion2/bottom_fill,/area)
"aY" = (/obj/map/noDenseMarker,/turf/village/horizontal_roof_vdalion2/bottom_right,/area)
"aZ" = (/turf/inn/floor,/turf/inn/rail/middle,/Region{desc = "Osrona's merchant district, Caelfall has a high number of shops and large homes for those more well off than the majority of the population. Within the middle is a large park with a small body of water within it's center. The jail, as well as the City Watch's headquarters is also known to be found here."; name = "Caelfall"})
"ba" = (/turf/inn/floor,/turf/shop_int/stairs/top_left,/Region{desc = "Osrona's merchant district, Caelfall has a high number of shops and large homes for those more well off than the majority of the population. Within the middle is a large park with a small body of water within it's center. The jail, as well as the City Watch's headquarters is also known to be found here."; name = "Caelfall"})
"bb" = (/turf/inn/floor,/turf/shop_int/stairs/top,/Region{desc = "Osrona's merchant district, Caelfall has a high number of shops and large homes for those more well off than the majority of the population. Within the middle is a large park with a small body of water within it's center. The jail, as well as the City Watch's headquarters is also known to be found here."; name = "Caelfall"})
"bc" = (/turf/inn/floor,/turf/shop_int/stairs/top_right,/Region{desc = "Osrona's merchant district, Caelfall has a high number of shops and large homes for those more well off than the majority of the population. Within the middle is a large park with a small body of water within it's center. The jail, as well as the City Watch's headquarters is also known to be found here."; name = "Caelfall"})
"bd" = (/turf/village/wall_vdalion/bottom,/turf/village/vdalion_extra/windowbig_3,/area)
"be" = (/turf/village/wall_vdalion/bottom,/turf/village/vdalion_extra/door_top,/area)
"bf" = (/turf/village/wall_vdalion/bottom_right,/area)
"bg" = (/turf/shop_int/stairs/left,/Region{desc = "Osrona's merchant district, Caelfall has a high number of shops and large homes for those more well off than the majority of the population. Within the middle is a large park with a small body of water within it's center. The jail, as well as the City Watch's headquarters is also known to be found here."; name = "Caelfall"})
"bh" = (/turf/shop_int/stairs/middle,/Region{desc = "Osrona's merchant district, Caelfall has a high number of shops and large homes for those more well off than the majority of the population. Within the middle is a large park with a small body of water within it's center. The jail, as well as the City Watch's headquarters is also known to be found here."; name = "Caelfall"})
"bi" = (/turf/shop_int/stairs/right,/Region{desc = "Osrona's merchant district, Caelfall has a high number of shops and large homes for those more well off than the majority of the population. Within the middle is a large park with a small body of water within it's center. The jail, as well as the City Watch's headquarters is also known to be found here."; name = "Caelfall"})
"bj" = (/obj/generic_shadow/white{alpha = 75; color = "black"; icon_state = "full"; name = "house shadow"},/turf/village/wall_vdalion/foundation_middle,/area)
"bk" = (/turf/village/wall_vdalion/foundation_middle,/area)
"bl" = (/Building/Warper/Exterior,/turf/village/vdalion_extra/door_bottom,/area)
"bm" = (/turf/village/wall_vdalion/foundation_right,/area)
"bn" = (/turf/city/wall/blue{icon_state = "Left"},/turf/shop_int/stairs/bottom_left,/Region{desc = "Osrona's merchant district, Caelfall has a high number of shops and large homes for those more well off than the majority of the population. Within the middle is a large park with a small body of water within it's center. The jail, as well as the City Watch's headquarters is also known to be found here."; name = "Caelfall"})
"bo" = (/turf/shop_int/stairs/bottom,/Region{desc = "Osrona's merchant district, Caelfall has a high number of shops and large homes for those more well off than the majority of the population. Within the middle is a large park with a small body of water within it's center. The jail, as well as the City Watch's headquarters is also known to be found here."; name = "Caelfall"})
"bp" = (/turf/city/wall/blue{density = 0; icon_state = "Right"},/turf/shop_int/stairs/bottom_right,/Region{desc = "Osrona's merchant district, Caelfall has a high number of shops and large homes for those more well off than the majority of the population. Within the middle is a large park with a small body of water within it's center. The jail, as well as the City Watch's headquarters is also known to be found here."; name = "Caelfall"})
"bq" = (/obj/generic_shadow/white{alpha = 50; color = "black"; icon_state = "tl_corner"; name = "house shadow corner"},/turf,/area)
"br" = (/turf/inn/floor,/obj/map/noDenseMarker,/turf/village/roof_vdalion2/left_7,/Region{desc = "Osrona's merchant district, Caelfall has a high number of shops and large homes for those more well off than the majority of the population. Within the middle is a large park with a small body of water within it's center. The jail, as well as the City Watch's headquarters is also known to be found here."; name = "Caelfall"})
"bs" = (/SmallPreview/Start,/turf,/area)
"bt" = (/turf/village/wall_vdalion/bottom,/BuildingDetails{building_category = "Vdalion"; building_cost = 50000; building_desc = "A modest building with 3 rooms."; building_guild = "Vdalion"; building_name = "V-Medium House C"; building_settlement_only = 1},/turf/village/horizontal_roof_vdalion2/bottom_fill,/area)

(1,1,1) = {"
aaaaabababababababacabababababaqaaaaaE
aaaaababababababadaeafabababababaaaaaa
aaaaabababababadagahaiafababababaaaaaa
aaaaababababadagagahaiaiafabababaaaaaa
aaaaabababajagagagakaiaiaialababaaaaaa
aaaaabababamagaganaoapaiaiaJarasaaaaaa
aaaaatauauavaganawaxayapaiazaAaBaaaaaa
aaaaaCaDaDaWaFawaGaHaGayaIazaAaBaaaaaa
aaaaaCaDaDbraKaLaMaMaMaMaNaOaAaBaaaaaa
aaaaaCaDaDaDaPaQaAaAaAaAaAaAaAaBaaaaaa
aaaaaCaDaDaDaRaSaTaUaVbtaVaUaXaYaaaaaa
aaaaaZbabbbcaZaZaPbdaGbeaGbdbfabaaaaaa
aaaaaRbgbhbibjbkbkbkbkblbkbkbmabaaaaaa
aaaabsbnbobpbqabababababababababaaaaaa
"}
