"a" = (/turf/void,/area)
"b" = (/obj/map/viewBlock,/turf/void,/area)
"c" = (/turf/house/roof/corner/br,/area)
"d" = (/turf/house/roof/bottom,/area)
"e" = (/turf/house/roof/corner/bl,/area)
"f" = (/turf/house/roof/right,/area)
"g" = (/MapLimit,/turf/void,/area)
"h" = (/turf/village/wall_vdalion/bottom,/turf/jianghu_house/shadow{density = 1},/area)
"i" = (/turf/village/wall_vdalion/bottom,/turf/jianghu_house/shadow{density = 1},/turf/village/vdalion_extra/windowbig_4,/area)
"j" = (/turf/house/roof/left,/area)
"k" = (/obj/generic_shadow/white{alpha = 50; color = "black"; icon_state = "full"; layer = 4},/turf/village/wall_vdalion/bottom,/area)
"l" = (/turf/village/wall_vdalion/bottom,/area)
"m" = (/turf/village/wall_vdalion/bottom,/obj/generic_shadow/white{alpha = 50; color = "black"; icon_state = "full"; layer = 4},/turf/jianghu_house/shadow{density = 1},/area)
"n" = (/obj/generic_shadow/white{alpha = 50; color = "black"; icon_state = "full"; layer = 4},/turf/village/wall_vdalion/foundation_middle,/area)
"o" = (/turf/village/wall_vdalion/foundation_middle,/area)
"p" = (/obj/generic_shadow/white{alpha = 50; color = "black"; icon_state = "full"; layer = 4},/obj/generic_shadow/white{alpha = 75; color = "black"; icon_state = "top"},/turf/inn/floor,/area)
"q" = (/obj/generic_shadow/white{alpha = 75; color = "black"; icon_state = "top"},/turf/inn/floor,/area)
"r" = (/obj/generic_shadow/white{alpha = 50; color = "black"; icon_state = "full"; layer = 4},/turf/inn/floor,/area)
"s" = (/turf/inn/floor,/area)
"t" = (/turf/house/roof/corner/tr,/area)
"u" = (/turf/house/roof/top,/area)
"v" = (/obj/map/DenseMarker,/turf/house/roof/top_right,/area)
"w" = (/Building/Warper/Dynamic{dynamic_id = "VMedium House B_3"},/turf/inn/floor,/area)
"x" = (/obj/map/DenseMarker,/turf/house/roof/top_left,/area)
"y" = (/turf/house/roof/corner/tl,/area)
"z" = (/obj/map/DenseMarker,/turf/house/roof/corner/tr,/area)
"A" = (/obj/map/cave_light,/obj/map/DenseMarker,/turf/house/roof/top,/area)
"B" = (/obj/map/DenseMarker,/turf/house/roof/corner/tl,/area)
"C" = (/turf/house/roof/bottom_left,/area)
"D" = (/turf/house/roof/bottom_right,/area)
"E" = (/turf/village/wall_vdalion/bottom_left,/turf/jianghu_house/shadow{density = 1},/area)
"F" = (/turf/village/wall_vdalion/bottom_right,/turf/jianghu_house/shadow{density = 1},/area)
"G" = (/turf/village/wall_vdalion/bottom,/turf/village/vdalion_extra/door_top,/area)
"H" = (/turf/village/wall_vdalion/bottom_left,/area)
"I" = (/turf/village/wall_vdalion/bottom_right,/area)
"J" = (/turf/village/wall_vdalion/bottom,/obj/map/cave_light,/turf/village/vdalion_extra/windowbig_3,/area)
"K" = (/turf/village/wall_vdalion/foundation_left,/area)
"L" = (/turf/village/wall_vdalion/foundation_right,/Region{desc = "Osrona's merchant district, Caelfall has a high number of shops and large homes for those more well off than the majority of the population. Within the middle is a large park with a small body of water within it's center. The jail, as well as the City Watch's headquarters is also known to be found here."; name = "Caelfall"})
"M" = (/obj/generic_shadow/white{alpha = 50; color = "black"; icon_state = "tl_corner"; name = "house shadow corner"},/obj/generic_shadow/white{alpha = 75; color = "black"; icon_state = "top"},/turf/inn/floor,/area)
"N" = (/turf/house/roof/top_right,/area)
"O" = (/obj/map/DenseMarker,/turf/shop_int/stairs/middle,/area)
"P" = (/Building/Warper/Dynamic{dynamic_id = "VMedium House B_1"},/turf/shop_int/stairs/middle,/area)
"Q" = (/turf/house/roof/top_left,/area)
"R" = (/Building/Warper/Dynamic{dynamic_id = "VMedium House B_4"},/turf/inn/floor,/area)
"S" = (/turf/castle_int/roof/middle,/area)
"T" = (/obj/map/DenseMarker,/turf/house/roof/bottom,/area)
"U" = (/turf/shop_int/stairs/middle,/area)
"V" = (/Building/Warper/Dynamic{dynamic_id = "VMedium House B_3"},/obj/map/noDenseMarker,/turf/village/vdalion_extra/door_bottom,/area)
"W" = (/Building/Warper/Dynamic{dynamic_id = "VMedium House B_2"},/turf/inn/floor,/area)
"X" = (/Building/Warper/Dynamic{dynamic_id = "VMedium House B_2"},/obj/map/noDenseMarker,/turf/village/vdalion_extra/door_bottom,/area)
"Y" = (/Building/Warper/Interior,/turf/inn/floor,/area)
"Z" = (/BuildingDetails{building_category = "Vdalion"; building_cost = 50000; building_desc = "A modest building with 3 rooms."; building_guild = "Vdalion"; building_interior = 1; building_name = "V-Medium House B"; building_settlement_only = 1},/turf/inn/floor,/area)

(1,1,1) = {"
aaaaaaaaaaaaaaaaaaaaaaaaaaaaaaaaaaaaaaaaaaaaaaaaaag
aaaaaaaaaaaaaaaaaaaaaaaaaaaaaaaaaaaaaaaaaaaaaaaaaaa
aaaaaaaaaaaaaaaaaaaaaaaaaaaaaaaaaaaaaaaaaaaaaaaaaaa
aaaaaaaaaaaaaaaaaaaaaaaaaaaaaaaaaaaaaaaaaaaaaaaaaaa
aaaaaaaaaaaaaaaaaaaaaaaaaaaaaaaaaaaaaaaaaaaaaaaaaaa
aaaaaaaaaaaaaaaaaaaaaaaaaaaaaaaaaaaaaaaaaaaaaaaaaaa
aaaaaaaaaaaaaaaaaaaaaaaaaaaaaaaaaaaaaaaaaaaaaaaaaaa
aaaaaaaaaaaaaaaaaaaaaaaaaaaaaaaaaaaaaaaaaaaaaaaaaaa
aaaaaaaaaaaaaaaaaaaaaaaaaaaaaaaaaaaaaaaaaaaaaaaaaaa
aaaaaaaaaaaaaaaaaaaaaaaaaaaaaaaaaaaaaaaaaaaaaaaaaaa
aaaaaaaaaaaaaaaaaaaaaaaaaaaaaaaaaaaaaaaaaaaaaaaaaaa
aaaaaaaaaaaaaaaaaaaaaaaaaaaaaaaaaaaaaaaaaaaaaaaaaaa
aaaaaaaaaaaaaaaaaaaaaaaaaaaaaaaaaaaaaaaaaaaaaaaaaaa
aaaaaaaaaaaaaaaaaaaaaaaaaaaaaaaaaaaaaaaaaaaaaaaaaaa
abbbbbbbbbbbbbbbbbbbbbbbbbbbbbbbbbbbbbbbbbaaaaaaaaa
abcdddddecdddddecdddddebaaaaaaaaaaaaaaaaabaaaaaaaaa
abfmhihhCDmhhhhCDmhihhjbacdddddddddddddeabaaaaaaaaa
abfklJllEFklGllEFklJlljbafmhihhhhhhhihhjabaaaaaaaaa
abfnooooHInoVooHInoooojbafklJlllllllJlljabaaaaaaaaa
abfpqqqqKLMqqqqKLMqqqqjbafnoooooooooooojabaaaaaaaaa
abfrssssssssssssssssssjbafpqqqqqqqqqqqqjabaaaaaaaaa
abfrssssssssssssssssssjbafrssssssssssssjabaaaaaaaaa
abfrssssssssssssssssssjbafrssssssssssssjabaaaaaaaaa
abfrssssssssssssssssssjbafrssssssssssssjabaaaaaaaaa
abtuNOPOQuuuuuuvRxuuuuybafrssssssssssssjabaaaaaaaaa
abaatuuuySSSSSSzABSSSSSbafrssssssssssssjabaaaaaaaaa
abaaSSSSSSSSSSSSSSSaaaabafrssssssssssssjabaaaaaaaaa
bbbbbbbbbbbbbbbbbbbbbbbbafrssssssssssssjabaaaaaaaaa
bacdddddecTTTecddddddeabafrssssssssssssjabaaaaaaaaa
bafmhihhCDOPOCDmhhhhhjabatuuuuuvwxuuuuuyabaaaaaaaaa
bafklJllEFUUUEFkllGlljabaaaaaaazABaaaaaaabaaaaaaaaa
bafnooooHIUUUHInooXoojabaaaaaaaaaaaaaaaaabaaaaaaaaa
bafpqqqqKLUUUKLMqqqqqjabbbbbbbbbbbbbbbbbbbaaaaaaaaa
bafrsssssssssssssssssjabaaaaaaaaaaaaaaaaabaaaaaaaaa
bafrsssssssssssssssssjabacdddddddddddddeabaaaaaaaaa
bafrsssssssssssssssssjabafmhihhhhhhhihhjabaaaaaaaaa
bafrsssssssssssssssssjabafklJlllllllJlljabaaaaaaaaa
bafrsssssssssssssssssjabafnoooooooooooojabaaaaaaaaa
bafrsssssssssssssssssjabafpqqqqqqqqqqqqjabaaaaaaaaa
bafrsssssssssQNssssssjabafrssssssssssssjabaaaaaaaaa
bafrsssssssssjtuuuuuuyabafrssssssssssssjabaaaaaaaaa
bafrsssssssssjaaaaaaaaabafrssssssssssssjabaaaaaaaaa
bafrsssssssssjaaaaaaaaabafrssssssssssssjabaaaaaaaaa
bafrsssssssssjaaaaaaaaabafrssssssssssssjabaaaaaaaaa
bafrsssssssssjaaaaaaaaabafrssssssssssssjabaaaaaaaaa
bafrsssZsssssjaaaaaaaaabafrssssssssssssjabaaaaaaaaa
bafrsssssssssjaaaaaaaaabafrssssssssssssjabaaaaaaaaa
batuuuvYxuuuuyaaaaaaaaabatuuuuuvWxuuuuuyabaaaaaaaaa
baaaaazABaaaaaaaaaaaaaabaaaaaaazABaaaaaaabaaaaaaaaa
baaaaaaaaaaaaaaaaaaaaaabaaaaaaaaaaaaaaaaabaaaaaaaaa
bbbbbbbbbbbbbbbbbbbbbbbbbbbbbbbbbbbbbbbbbbaaaaaaaaa
"}
