"a" = (/turf/void,/area)
"b" = (/obj/map/viewBlock,/turf/void,/area)
"c" = (/turf/house/roof/corner/br,/area)
"d" = (/turf/house/roof/bottom,/area)
"e" = (/turf/house/roof/corner/bl,/area)
"f" = (/turf/house/roof/right,/area)
"g" = (/MapLimit,/turf/void,/area)
"h" = (/turf/village/wall_vdalion/bottom,/turf/jianghu_house/shadow{density = 1},/area)
"i" = (/turf/village/wall_vdalion/bottom,/turf/jianghu_house/shadow{density = 1},/turf/village/vdalion_extra/windowbig_4,/area)
"j" = (/turf/house/roof/left,/area)
"k" = (/obj/generic_shadow/white{alpha = 50; color = "black"; icon_state = "full"; layer = 4},/turf/village/wall_vdalion/bottom,/area)
"l" = (/turf/village/wall_vdalion/bottom,/area)
"m" = (/turf/village/wall_vdalion/bottom,/obj/generic_shadow/white{alpha = 50; color = "black"; icon_state = "full"; layer = 4},/turf/jianghu_house/shadow{density = 1},/area)
"n" = (/obj/generic_shadow/white{alpha = 50; color = "black"; icon_state = "full"; layer = 4},/turf/village/wall_vdalion/foundation_middle,/area)
"o" = (/turf/village/wall_vdalion/foundation_middle,/area)
"p" = (/obj/generic_shadow/white{alpha = 50; color = "black"; icon_state = "full"; layer = 4},/obj/generic_shadow/white{alpha = 75; color = "black"; icon_state = "top"},/turf/inn/floor,/area)
"q" = (/obj/generic_shadow/white{alpha = 75; color = "black"; icon_state = "top"},/turf/inn/floor,/area)
"r" = (/obj/generic_shadow/white{alpha = 50; color = "black"; icon_state = "full"; layer = 4},/turf/inn/floor,/area)
"s" = (/turf/inn/floor,/area)
"t" = (/turf/house/roof/corner/tr,/area)
"u" = (/turf/house/roof/top,/area)
"v" = (/obj/map/DenseMarker,/turf/house/roof/top_right,/area)
"w" = (/Building/Warper/Dynamic{dynamic_id = "vdalionA_room1"},/turf/inn/floor,/area)
"x" = (/obj/map/DenseMarker,/turf/house/roof/top_left,/area)
"y" = (/turf/house/roof/corner/tl,/area)
"z" = (/obj/map/DenseMarker,/turf/house/roof/corner/tr,/area)
"A" = (/obj/map/cave_light,/obj/map/DenseMarker,/turf/house/roof/top,/area)
"B" = (/obj/map/DenseMarker,/turf/house/roof/corner/tl,/area)
"C" = (/obj/map/DenseMarker,/turf/house/roof/bottom,/area)
"D" = (/obj/map/cave_light,/obj/map/DenseMarker,/turf/house/roof/bottom,/area)
"E" = (/turf/house/roof/bottom_left,/area)
"F" = (/turf/house/roof/bottom_right,/area)
"G" = (/obj/map/DenseMarker,/turf/shop_int/stairs/middle,/area)
"H" = (/Building/Warper/Dynamic{dynamic_id = "vdalionA_room1"},/turf/shop_int/stairs/middle,/area)
"I" = (/turf/village/wall_vdalion/bottom_left,/turf/jianghu_house/shadow{density = 1},/area)
"J" = (/turf/village/wall_vdalion/bottom_right,/turf/jianghu_house/shadow{density = 1},/area)
"K" = (/turf/shop_int/stairs/middle,/area)
"L" = (/turf/village/wall_vdalion/bottom_left,/area)
"M" = (/turf/village/wall_vdalion/bottom_right,/area)
"N" = (/turf/village/wall_vdalion/foundation_left,/area)
"O" = (/turf/village/wall_vdalion/foundation_right,/Region{desc = "Osrona's merchant district, Caelfall has a high number of shops and large homes for those more well off than the majority of the population. Within the middle is a large park with a small body of water within it's center. The jail, as well as the City Watch's headquarters is also known to be found here."; name = "Caelfall"})
"P" = (/obj/generic_shadow/white{alpha = 50; color = "black"; icon_state = "tl_corner"},/obj/generic_shadow/white{alpha = 75; color = "black"; icon_state = "top"},/turf/inn/floor,/area)
"Q" = (/turf/house/roof/top_left,/area)
"R" = (/turf/house/roof/top_right,/area)
"S" = (/turf/village/wall_vdalion/bottom,/obj/map/cave_light,/turf/village/vdalion_extra/windowbig_3,/area)
"T" = (/Building/Warper/Interior,/turf/inn/floor,/area)
"U" = (/BuildingDetails{building_category = "Vdalion"; building_cost = 25000; building_desc = "A building with 2 rooms."; building_guild = "Vdalion"; building_interior = 1; building_name = "V-Small House A"; building_settlement_only = 1},/turf/inn/floor,/area)

(1,1,1) = {"
aaaaaaaaaaaaaaaaaaaaaaaaaaaaaaaaaaaaaaaaaaaaaaaaaag
aaaaaaaaaaaaaaaaaaaaaaaaaaaaaaaaaaaaaaaaaaaaaaaaaaa
aaaaaaaaaaaaaaaaaaaaaaaaaaaaaaaaaaaaaaaaaaaaaaaaaaa
aaaaaaaaaaaaaaaaaaaaaaaaaaaaaaaaaaaaaaaaaaaaaaaaaaa
aaaaaaaaaaaaaaaaaaaaaaaaaaaaaaaaaaaaaaaaaaaaaaaaaaa
aaaaaaaaaaaaaaaaaaaaaaaaaaaaaaaaaaaaaaaaaaaaaaaaaaa
aaaaaaaaaaaaaaaaaaaaaaaaaaaaaaaaaaaaaaaaaaaaaaaaaaa
aaaaaaaaaaaaaaaaaaaaaaaaaaaaaaaaaaaaaaaaaaaaaaaaaaa
aaaaaaaaaaaaaaaaaaaaaaaaaaaaaaaaaaaaaaaaaaaaaaaaaaa
aabbbbbbbbbbbbbbbbbbbaaaaaaaaaaaaaaaaaaaaaaaaaaaaaa
aabaaaaaaaaaaaaaaaaabaaaaaaaaaaaaaaaaaaaaaaaaaaaaaa
aabacdddddddddddddeabaaaaaaaaaaaaaaaaaaaaaaaaaaaaaa
aabafmhihhhhhhhihhjabaaaaaaaaaaaaaaaaaaaaaaaaaaaaaa
aabafklSlllllllSlljabaaaaaaaaaaaaaaaaaaaaaaaaaaaaaa
aabafnoooooooooooojabaaaaaaaaaaaaaaaaaaaaaaaaaaaaaa
aabafpqqqqqqqqqqqqjabaaaaaaaaaaaaaaaaaaaaaaaaaaaaaa
aabafrssssssssssssjabaaaaaaaaaaaaaaaaaaaaaaaaaaaaaa
aabafrssssssssssssjabaaaaaaaaaaaaaaaaaaaaaaaaaaaaaa
aabafrssssssssssssjabaaaaaaaaaaaaaaaaaaaaaaaaaaaaaa
aabafrssssssssssssjabaaaaaaaaaaaaaaaaaaaaaaaaaaaaaa
aabafrssssssssssssjabaaaaaaaaaaaaaaaaaaaaaaaaaaaaaa
aabafrssssssssssssjabaaaaaaaaaaaaaaaaaaaaaaaaaaaaaa
aabafrssssssssssssjabaaaaaaaaaaaaaaaaaaaaaaaaaaaaaa
aabafrssssssssssssjabaaaaaaaaaaaaaaaaaaaaaaaaaaaaaa
aabatuuuuuvwxuuuuuyabaaaaaaaaaaaaaaaaaaaaaaaaaaaaaa
aabaaaaaaazABaaaaaaabaaaaaaaaaaaaaaaaaaaaaaaaaaaaaa
aabaaaaaaaaaaaaaaaaabaaaaaaaaaaaaaaaaaaaaaaaaaaaaaa
bbbbbbbbbbbbbbbbbbbbbbbbaaaaaaaaaaaaaaaaaaaaaaaaaaa
bacdddddecCDCecddddddeabaaaaaaaaaaaaaaaaaaaaaaaaaaa
bafmhihhEFGHGEFmhhihhjabaaaaaaaaaaaaaaaaaaaaaaaaaaa
bafklSllIJKKKIJkllSlljabaaaaaaaaaaaaaaaaaaaaaaaaaaa
bafnooooLMKKKLMnooooojabaaaaaaaaaaaaaaaaaaaaaaaaaaa
bafpqqqqNOKKKNOPqqqqqjabaaaaaaaaaaaaaaaaaaaaaaaaaaa
bafrsssssssssssssssssjabaaaaaaaaaaaaaaaaaaaaaaaaaaa
bafrsssssssssssssssssjabaaaaaaaaaaaaaaaaaaaaaaaaaaa
bafrsssssssssssssssssjabaaaaaaaaaaaaaaaaaaaaaaaaaaa
bafrsssssssssssssssssjabaaaaaaaaaaaaaaaaaaaaaaaaaaa
bafrsssssssssssssssssjabaaaaaaaaaaaaaaaaaaaaaaaaaaa
bafrsssssssssssssssssjabaaaaaaaaaaaaaaaaaaaaaaaaaaa
bafrsssssssssQRssssssjabaaaaaaaaaaaaaaaaaaaaaaaaaaa
bafrsssssssssjtuuuuuuyabaaaaaaaaaaaaaaaaaaaaaaaaaaa
bafrsssssssssjaaaaaaaaabaaaaaaaaaaaaaaaaaaaaaaaaaaa
bafrsssssssssjaaaaaaaaabaaaaaaaaaaaaaaaaaaaaaaaaaaa
bafrsssssssssjaaaaaaaaabaaaaaaaaaaaaaaaaaaaaaaaaaaa
bafrsssssssssjaaaaaaaaabaaaaaaaaaaaaaaaaaaaaaaaaaaa
bafrsssUsssssjaaaaaaaaabaaaaaaaaaaaaaaaaaaaaaaaaaaa
bafrsssssssssjaaaaaaaaabaaaaaaaaaaaaaaaaaaaaaaaaaaa
batuuuvTxuuuuyaaaaaaaaabaaaaaaaaaaaaaaaaaaaaaaaaaaa
baaaaazABaaaaaaaaaaaaaabaaaaaaaaaaaaaaaaaaaaaaaaaaa
baaaaaaaaaaaaaaaaaaaaaabaaaaaaaaaaaaaaaaaaaaaaaaaaa
bbbbbbbbbbbbbbbbbbbbbbbbaaaaaaaaaaaaaaaaaaaaaaaaaaa
"}
