"aa" = (/turf/void,/area)
"ab" = (/turf,/area)
"ac" = (/obj/map/noDenseMarker,/turf/village/roof_vdalion/center_3,/area)
"ad" = (/SmallPreview/End,/turf,/area)
"ae" = (/obj/map/noDenseMarker,/turf/village/roof_vdalion/left_3,/area)
"af" = (/obj/map/noDenseMarker,/turf/village/roof_vdalion/center_2,/area)
"ag" = (/obj/map/noDenseMarker,/turf/village/roof_vdalion/right_3,/area)
"ah" = (/turf/village/roof_vdalion/left_2,/area)
"ai" = (/turf/village/roof_vdalion/center_2,/turf/village/horizontal_roof_vdalion/top_left,/turf/village/roof_vdalion/center_3{layer = 7},/area)
"aj" = (/turf/village/roof_vdalion/right_2,/turf/village/horizontal_roof_vdalion/top_fill,/area)
"ak" = (/MapLimit,/turf/void,/area)
"al" = (/obj/map/noDenseMarker,/turf/village/horizontal_roof_vdalion/top_fill,/area)
"am" = (/obj/map/noDenseMarker,/turf/village/horizontal_roof_vdalion/top_right,/area)
"an" = (/turf/village/roof_vdalion/center_2,/area)
"ao" = (/turf/village/horizontal_roof_vdalion/fill,/turf/village/roof_vdalion/right_3{layer = 7},/area)
"ap" = (/turf/village/horizontal_roof_vdalion/fill,/area)
"aq" = (/obj/map/noDenseMarker,/turf/village/horizontal_roof_vdalion/right,/area)
"ar" = (/obj/map/noDenseMarker,/turf/village/roof_vdalion/left_5,/area)
"as" = (/turf/village/wall_vdalion/top_middle,/turf/village/roof_vdalion/center_1,/area)
"at" = (/turf/village/roof_vdalion/right_2,/area)
"au" = (/obj/map/noDenseMarker,/turf/village/roof_vdalion/left_6,/area)
"av" = (/turf/village/wall_vdalion/top_left,/turf/village/roof_vdalion/left_1,/area)
"aw" = (/turf/village/wall_vdalion/top_middle,/turf/village/roof_vdalion/left_4,/turf/village/roof_vdalion/right_4,/area)
"ax" = (/turf/village/wall_vdalion/top_right,/turf/village/roof_vdalion/right_1,/area)
"ay" = (/turf/village/wall_vdalion/top_middle,/turf/village/roof_vdalion/left_4,/area)
"az" = (/turf/village/wall_vdalion/top_middle,/area)
"aA" = (/turf/village/wall_vdalion/top_middle,/turf/village/roof_vdalion/right_4,/area)
"aB" = (/turf/village/roof_vdalion/right_3,/obj/map/noDenseMarker,/turf/village/horizontal_roof_vdalion/top_fill,/area)
"aC" = (/turf/village/wall_vdalion/top_middle,/turf/village/horizontal_roof_vdalion/bottom_fill,/area)
"aD" = (/turf/village/wall_vdalion/top_middle,/turf/village/vdalion_extra/windowbig_4,/turf/village/horizontal_roof_vdalion/bottom_fill,/area)
"aE" = (/turf/village/wall_vdalion/top_right,/turf/village/horizontal_roof_vdalion/bottom_fill,/area)
"aF" = (/obj/map/noDenseMarker,/turf/village/horizontal_roof_vdalion/bottom_right,/area)
"aG" = (/turf/village/wall_vdalion/top_middle,/turf/village/vdalion_extra/windowbig_4,/turf/village/roof_vdalion/left_4,/area)
"aH" = (/turf/village/wall_vdalion/top_middle,/turf/village/vdalion_extra/windowbig_4,/turf/village/roof_vdalion/right_4,/area)
"aI" = (/turf/village/wall_vdalion/top_middle,/turf/village/horizontal_roof_vdalion/bottom_fill,/obj/generic_shadow/white{alpha = 50; color = "black"; icon_state = "full"},/turf/village/roof_vdalion/right_5{layer = 7},/area)
"aJ" = (/turf/village/wall_vdalion/top_middle,/turf/village/vdalion_extra/windowbig_3,/area)
"aK" = (/turf/village/wall_vdalion/top_right,/area)
"aL" = (/obj/map/noDenseMarker,/turf/village/roof_vdalion/left_7,/area)
"aM" = (/turf/village/wall_vdalion/top_left,/turf/village/roof_vdalion/left_4,/area)
"aN" = (/turf/village/wall_vdalion/top_right,/turf/village/roof_vdalion/right_4,/area)
"aO" = (/turf/village/wall_vdalion/top_middle,/obj/generic_shadow/white{alpha = 50; color = "black"; icon_state = "full"},/turf/village/roof_vdalion/right_6{layer = 7},/area)
"aP" = (/turf/village/wall_vdalion/middle,/area)
"aQ" = (/turf/village/wall_vdalion/middle,/turf/village/vdalion_extra/windowbig_5,/area)
"aR" = (/turf/village/wall_vdalion/middle_right,/area)
"aS" = (/turf/village/wall_vdalion/middle_left,/area)
"aT" = (/obj/generic_shadow/white{alpha = 75; color = "black"; icon_state = "top"},/obj/generic_shadow/white{alpha = 50; color = "black"; icon_state = "tl_corner"; name = "house shadow corner"},/turf/inn/floor,/Region{desc = "Osrona's merchant district, Caelfall has a high number of shops and large homes for those more well off than the majority of the population. Within the middle is a large park with a small body of water within it's center. The jail, as well as the City Watch's headquarters is also known to be found here."; name = "Caelfall"})
"aU" = (/obj/generic_shadow/white{alpha = 75; color = "black"; icon_state = "top"},/turf/inn/floor,/Region{desc = "Osrona's merchant district, Caelfall has a high number of shops and large homes for those more well off than the majority of the population. Within the middle is a large park with a small body of water within it's center. The jail, as well as the City Watch's headquarters is also known to be found here."; name = "Caelfall"})
"aV" = (/turf/village/wall_vdalion/middle,/obj/generic_shadow/white{alpha = 50; color = "black"; icon_state = "full"},/turf/village/roof_vdalion/right_7{layer = 7},/area)
"aW" = (/obj/generic_shadow/white{alpha = 50; color = "black"; icon_state = "full"},/turf/village/wall_vdalion/bottom_right,/area)
"aX" = (/turf/village/wall_vdalion/bottom_left,/area)
"aY" = (/turf/inn/floor,/obj/generic_shadow/white{alpha = 75; color = "black"; icon_state = "top"},/turf/inn/rail/right{layer = 3.2},/Region{desc = "Osrona's merchant district, Caelfall has a high number of shops and large homes for those more well off than the majority of the population. Within the middle is a large park with a small body of water within it's center. The jail, as well as the City Watch's headquarters is also known to be found here."; name = "Caelfall"})
"aZ" = (/turf/inn/floor,/Region{desc = "Osrona's merchant district, Caelfall has a high number of shops and large homes for those more well off than the majority of the population. Within the middle is a large park with a small body of water within it's center. The jail, as well as the City Watch's headquarters is also known to be found here."; name = "Caelfall"})
"ba" = (/turf/inn/floor,/turf/inn/rail/right{layer = 3.2},/Region{desc = "Osrona's merchant district, Caelfall has a high number of shops and large homes for those more well off than the majority of the population. Within the middle is a large park with a small body of water within it's center. The jail, as well as the City Watch's headquarters is also known to be found here."; name = "Caelfall"})
"bb" = (/turf/inn/floor,/turf/inn/rail/middle,/Region{desc = "Osrona's merchant district, Caelfall has a high number of shops and large homes for those more well off than the majority of the population. Within the middle is a large park with a small body of water within it's center. The jail, as well as the City Watch's headquarters is also known to be found here."; name = "Caelfall"})
"bc" = (/turf/inn/floor,/turf/shop_int/stairs/top_left,/Region{desc = "Osrona's merchant district, Caelfall has a high number of shops and large homes for those more well off than the majority of the population. Within the middle is a large park with a small body of water within it's center. The jail, as well as the City Watch's headquarters is also known to be found here."; name = "Caelfall"})
"bd" = (/turf/inn/floor,/turf/shop_int/stairs/top,/Region{desc = "Osrona's merchant district, Caelfall has a high number of shops and large homes for those more well off than the majority of the population. Within the middle is a large park with a small body of water within it's center. The jail, as well as the City Watch's headquarters is also known to be found here."; name = "Caelfall"})
"be" = (/turf/inn/floor,/turf/shop_int/stairs/top_right,/Region{desc = "Osrona's merchant district, Caelfall has a high number of shops and large homes for those more well off than the majority of the population. Within the middle is a large park with a small body of water within it's center. The jail, as well as the City Watch's headquarters is also known to be found here."; name = "Caelfall"})
"bf" = (/obj/generic_shadow/white{alpha = 50; color = "black"; icon_state = "full"},/turf/village/wall_vdalion/foundation_right,/Region{desc = "Osrona's merchant district, Caelfall has a high number of shops and large homes for those more well off than the majority of the population. Within the middle is a large park with a small body of water within it's center. The jail, as well as the City Watch's headquarters is also known to be found here."; name = "Caelfall"})
"bg" = (/turf/village/wall_vdalion/foundation_left,/area)
"bh" = (/turf/village/wall_vdalion/bottom_left,/turf/jianghu_house/shadow{density = 1},/area)
"bi" = (/turf/shop_int/stairs/left,/Region{desc = "Osrona's merchant district, Caelfall has a high number of shops and large homes for those more well off than the majority of the population. Within the middle is a large park with a small body of water within it's center. The jail, as well as the City Watch's headquarters is also known to be found here."; name = "Caelfall"})
"bj" = (/turf/shop_int/stairs/middle,/Region{desc = "Osrona's merchant district, Caelfall has a high number of shops and large homes for those more well off than the majority of the population. Within the middle is a large park with a small body of water within it's center. The jail, as well as the City Watch's headquarters is also known to be found here."; name = "Caelfall"})
"bk" = (/turf/shop_int/stairs/right,/Region{desc = "Osrona's merchant district, Caelfall has a high number of shops and large homes for those more well off than the majority of the population. Within the middle is a large park with a small body of water within it's center. The jail, as well as the City Watch's headquarters is also known to be found here."; name = "Caelfall"})
"bl" = (/turf/inn/floor,/obj/generic_shadow/white{alpha = 75; color = "black"; icon_state = "top"},/turf/inn/rail/left{layer = 3.2},/Region{desc = "Osrona's merchant district, Caelfall has a high number of shops and large homes for those more well off than the majority of the population. Within the middle is a large park with a small body of water within it's center. The jail, as well as the City Watch's headquarters is also known to be found here."; name = "Caelfall"})
"bm" = (/turf/village/wall_vdalion/bottom,/obj/generic_shadow/white{alpha = 50; color = "black"; icon_state = "full"},/turf/jianghu_house/shadow{density = 1},/area)
"bn" = (/turf/village/wall_vdalion/bottom,/turf/jianghu_house/shadow{density = 1},/turf/village/vdalion_extra/windowbig_4,/area)
"bo" = (/turf/village/wall_vdalion/bottom,/turf/jianghu_house/shadow{density = 1},/area)
"bp" = (/turf/village/wall_vdalion/bottom_right,/turf/jianghu_house/shadow{density = 1},/area)
"bq" = (/obj/generic_shadow/white{alpha = 50; color = "black"; icon_state = "full"},/turf,/area)
"br" = (/obj/generic_shadow/white{alpha = 50; color = "black"; icon_state = "full"},/turf/village/wall_vdalion/bottom,/area)
"bs" = (/turf/village/wall_vdalion/bottom,/turf/village/vdalion_extra/door_top,/area)
"bt" = (/turf/village/wall_vdalion/bottom,/turf/village/vdalion_extra/windowbig_3,/area)
"bu" = (/turf/village/wall_vdalion/bottom,/area)
"bv" = (/turf/village/wall_vdalion/bottom_right,/area)
"bw" = (/obj/generic_shadow/white{alpha = 50; color = "black"; icon_state = "full"},/turf/village/wall_vdalion/foundation_middle,/Region{desc = "Osrona's merchant district, Caelfall has a high number of shops and large homes for those more well off than the majority of the population. Within the middle is a large park with a small body of water within it's center. The jail, as well as the City Watch's headquarters is also known to be found here."; name = "Caelfall"})
"bx" = (/Building/Warper/Exterior,/turf/village/vdalion_extra/door_bottom,/Region{desc = "Osrona's merchant district, Caelfall has a high number of shops and large homes for those more well off than the majority of the population. Within the middle is a large park with a small body of water within it's center. The jail, as well as the City Watch's headquarters is also known to be found here."; name = "Caelfall"})
"by" = (/turf/village/wall_vdalion/foundation_middle,/Region{desc = "Osrona's merchant district, Caelfall has a high number of shops and large homes for those more well off than the majority of the population. Within the middle is a large park with a small body of water within it's center. The jail, as well as the City Watch's headquarters is also known to be found here."; name = "Caelfall"})
"bz" = (/turf/village/wall_vdalion/foundation_right,/Region{desc = "Osrona's merchant district, Caelfall has a high number of shops and large homes for those more well off than the majority of the population. Within the middle is a large park with a small body of water within it's center. The jail, as well as the City Watch's headquarters is also known to be found here."; name = "Caelfall"})
"bA" = (/obj/generic_shadow/white{alpha = 50; color = "black"; icon_state = "tl_corner"; name = "house shadow corner"},/turf,/area)
"bB" = (/SmallPreview/Start,/turf,/area)
"bC" = (/turf/city/wall/blue{icon_state = "Left"},/turf/shop_int/stairs/bottom_left,/Region{desc = "Osrona's merchant district, Caelfall has a high number of shops and large homes for those more well off than the majority of the population. Within the middle is a large park with a small body of water within it's center. The jail, as well as the City Watch's headquarters is also known to be found here."; name = "Caelfall"})
"bD" = (/turf/shop_int/stairs/bottom,/Region{desc = "Osrona's merchant district, Caelfall has a high number of shops and large homes for those more well off than the majority of the population. Within the middle is a large park with a small body of water within it's center. The jail, as well as the City Watch's headquarters is also known to be found here."; name = "Caelfall"})
"bE" = (/turf/city/wall/blue{density = 0; icon_state = "Right"},/turf/shop_int/stairs/bottom_right,/Region{desc = "Osrona's merchant district, Caelfall has a high number of shops and large homes for those more well off than the majority of the population. Within the middle is a large park with a small body of water within it's center. The jail, as well as the City Watch's headquarters is also known to be found here."; name = "Caelfall"})
"bF" = (/turf/village/wall_vdalion/bottom,/BuildingDetails{building_category = "Vdalion"; building_cost = 50000; building_desc = "An apartment complex."; building_guild = "Vdalion"; building_interior = 0; building_name = "VS-Apartment"; building_settlement_only = 1},/turf/jianghu_house/shadow{density = 1},/area)

(1,1,1) = {"
aaababababacabababababababababababababadak
aaabababaeafagabababababababababababababaa
aaababaeahaiajaBalalalalalalalalalalalamaa
aaabaeahahanaoapapapapapapapapapapapapaqaa
aaarahahahasataoapapapapapapapapapapapaqaa
aaauahahavawaxataoapapapapapapapapapapaqaa
aaauahavayazaAaxataIaCaDaCaDaCaDaCaCaEaFaa
aaauavaGazazazaHaxaOazaJazaJazaJazazaKabaa
aaaLaMaJazazazaJaNaVaPaQaPaQaPaQaPaPaRabaa
aaabaSaQaPaPaPaQaRaTaUaUaUaUaUaUaUaYaWabaa
aaabaXblaUaUaUaUaUaZaZaZaZaZaZaZaZbaaWabaa
aaabaXbbbcbdbebbbbbbbbbbbbbbbbbbbbbbbfabaa
aaabbgbhbibjbkbmbFbnbobnbobnbobnbobpbqabaa
aaababaXbibjbkbrbsbtbubtbubtbubtbubvbqabaa
aaababbgbibjbkbwbxbybybybybybybybybzbAabaa
aabBababbCbDbEbAababababababababababababaa
aaaaaaaaaaaaaaaaaaaaaaaaaaaaaaaaaaaaaaaaaa
"}
