"aa" = (/turf/void,/area)
"ab" = (/turf,/area)
"ac" = (/obj/map/noDenseMarker,/turf/village/building/roof/roof_3/center/center_3,/area)
"ad" = (/SmallPreview/End,/turf,/area)
"ae" = (/MapLimit,/turf/void,/area)
"af" = (/obj/map/noDenseMarker,/turf/village/building/roof/roof_3/left/left_3,/area)
"ag" = (/obj/map/noDenseMarker,/turf/village/building/roof/roof_3/center/center_2,/area)
"ah" = (/obj/map/noDenseMarker,/turf/village/building/roof/roof_3/right/right_3,/area)
"ai" = (/obj/map/noDenseMarker,/turf/village/horizontal_roof/top/left,/area)
"aj" = (/obj/map/noDenseMarker,/turf/village/horizontal_roof/top{layer = 7},/area)
"ak" = (/obj/map/noDenseMarker,/turf/village/horizontal_roof/top,/area)
"al" = (/turf/village/building/roof/roof_3/left/left_3{layer = 5},/obj/map/noDenseMarker,/turf/village/horizontal_roof/top,/area)
"am" = (/turf/village/building/roof/roof_3/left/left_2{layer = 5},/turf/village/horizontal_roof/top,/area)
"an" = (/turf/village/building/roof/roof_3/center/center_2{layer = 5},/turf/village/horizontal_roof/top/right,/turf/village/building/roof/roof_3/center/center_3{layer = 9},/area)
"ao" = (/turf/village/building/roof/roof_3/right/right_2,/area)
"ap" = (/obj/map/noDenseMarker,/turf/village/horizontal_roof/top/left/fill,/area)
"aq" = (/turf/village/horizontal_roof/fill,/area)
"ar" = (/turf/village/horizontal_roof/fill,/turf/village/building/roof/roof_3/left/left_3,/area)
"as" = (/turf/village/building/roof/roof_3/center/center_2,/turf/village/horizontal_roof/top/right{layer = 7},/turf/village/building/roof/roof_3/center/center_3{layer = 8},/area)
"at" = (/turf/village/building/roof/roof_3/left/left_2,/area)
"au" = (/turf/village/building/wall/wall_1/middle/center,/turf/extra_roof/wood,/turf/village/building/roof/roof_3/center/center_1,/turf/village/horizontal_roof/slope/peak,/area)
"av" = (/obj/map/noDenseMarker,/turf/village/horizontal_roof/edge/right{layer = 3},/area)
"aw" = (/turf/village/building/wall/wall_1/middle/center,/turf/extra_roof/wood,/turf/village/building/roof/roof_3/left/left_1,/turf/village/horizontal_roof/slope/left,/area)
"ax" = (/turf/village/building/wall/wall_1/middle/center,/turf/extra_roof/wood,/turf/village/horizontal_roof/slope/right/corner,/turf/village/horizontal_roof/slope/left/corner,/area)
"ay" = (/turf/village/building/wall/wall_1/middle/center,/turf/extra_roof/wood,/turf/village/building/roof/roof_3/right/right_1,/turf/village/horizontal_roof/slope/right,/area)
"az" = (/obj/map/noDenseMarker,/turf/village/horizontal_roof/edge/right/middle{layer = 3},/area)
"aA" = (/turf/village/horizontal_roof/bottom/left,/area)
"aB" = (/turf/village/building/wall/wall_2/top/left,/turf/village/horizontal_roof/bottom,/turf/extra_roof/wood/left,/area)
"aC" = (/turf/village/building/wall/wall_2/top/top,/turf/village/horizontal_roof/bottom,/area)
"aD" = (/turf/village/building/wall/wall_2/top/right,/turf/village/horizontal_roof/bottom,/turf/village/horizontal_roof/edge/left/middle,/area)
"aE" = (/turf/village/building/wall/wall_1/middle/center,/turf/village/building/roof/roof_3/left/left_1,/turf/village/horizontal_roof/slope/left,/turf/extra_roof/wood,/area)
"aF" = (/turf/village/building/wall/wall_1/middle/center,/turf/extra_roof/wood,/turf/village/horizontal_roof/slope/left/corner,/area)
"aG" = (/turf/village/building/wall/wall_1/middle/center,/turf/extra_roof/wood,/area)
"aH" = (/turf/village/building/wall/wall_1/middle/center,/turf/extra_roof/wood,/turf/village/horizontal_roof/slope/right/corner,/area)
"aI" = (/turf/village/building/wall/wall_2/middle/left,/turf/extra_roof/wood/left,/area)
"aJ" = (/turf/village/building/wall/wall_2/middle/middle,/area)
"aK" = (/turf/village/building/wall/wall_2/middle/right,/turf/village/horizontal_roof/edge/left/middle,/area)
"aL" = (/turf/village/building/wall/wall_1/middle/center,/turf/village/building/roof/roof_3/left/left_1,/turf/village/horizontal_roof/slope/left,/area)
"aM" = (/turf/village/building/wall/wall_1/middle/center,/turf/extra_roof/wood,/turf/house/wooden_window{density = 1; icon_state = "pointy_top"},/turf/village/horizontal_roof/slope/left/corner,/area)
"aN" = (/turf/village/building/wall/wall_1/middle/center,/turf/extra_roof/wood,/turf/village/horizontal_roof/slope/right/corner,/turf/house/wooden_window{density = 1; icon_state = "pointy_top"},/area)
"aO" = (/turf/village/building/wall/wall_1/middle/center,/turf/extra_roof/wood/right,/turf/village/building/roof/roof_3/right/right_1,/turf/village/horizontal_roof/slope/right,/area)
"aP" = (/turf/village/building/wall/wall_2/bottom/left,/turf/extra_roof/wood/left,/area)
"aQ" = (/turf/village/building/wall/wall_1/middle/center,/turf/extra_roof/wood/left,/turf/village/horizontal_roof/slope/left/corner,/area)
"aR" = (/turf/house/wooden_window{density = 1; icon_state = "window_middle"},/turf/house/wooden_window{density = 1; icon_state = "foilage1_top"},/area)
"aS" = (/turf/village/building/wall/wall_1/middle/center,/turf/extra_roof/wood/right,/turf/village/horizontal_roof/slope/right/corner,/area)
"aT" = (/obj/map/noDenseMarker,/turf/village/horizontal_roof/corner/right{layer = 3},/area)
"aU" = (/turf/extra_roof/wall/middle/two,/turf/extra_roof/wood/top/left,/area)
"aV" = (/turf/village/building/wall/wall_2/bottom/middle,/area)
"aW" = (/obj/generic_shadow/white{alpha = 75; color = "black"; icon_state = "top"},/turf/shop_int/floor,/area)
"aX" = (/turf/village/building/wall/wall_1/middle/center,/turf/extra_roof/wood/bottom/left,/turf/extra_roof/wood/top/left,/area)
"aY" = (/turf/village/building/wall/wall_2/bottom/right,/turf/village/horizontal_roof/corner/left,/area)
"aZ" = (/turf/village/building/wall/wall_1/middle/center,/turf/extra_roof/wood/top,/area)
"ba" = (/turf/village/building/wall/wall_1/middle/center,/turf/extra_roof/wood/top,/turf/house/wooden_window{density = 1; icon_state = "foilage1_bottom"},/area)
"bb" = (/turf/village/building/wall/wall_1/middle/center,/turf/extra_roof/wood/bottom/right,/turf/extra_roof/wood/top/right,/area)
"bc" = (/turf/city/wall/bottom,/turf/extra_roof/wood/left,/area)
"bd" = (/turf/shop_int/floor,/turf/inn/rail/left,/area)
"be" = (/turf/shop_int/floor,/area)
"bf" = (/turf/village/building/wall/wall_2/bottom/middle,/turf/inn/rail/top_left,/area)
"bg" = (/turf/extra_roof/wall/middle/two,/turf/extra_roof/wood/right,/turf/extra_roof/wood/top/right,/area)
"bh" = (/turf/city/wall/bottom,/turf/extra_roof/wood/bottom/left,/area)
"bi" = (/turf/shop_int/floor,/turf/inn/rail/bottom_left,/area)
"bj" = (/turf/shop_int/floor,/turf/inn/rail/middle,/area)
"bk" = (/turf/shop_int/floor,/turf/shop_int/stairs/top_left,/area)
"bl" = (/turf/shop_int/floor,/turf/shop_int/stairs/top,/area)
"bm" = (/turf/shop_int/floor,/turf/shop_int/stairs/top_right,/area)
"bn" = (/turf/shop_int/floor,/turf/inn/rail/bottom_right,/area)
"bo" = (/turf/city/wall/bottom,/turf/extra_roof/wood/right,/area)
"bp" = (/turf/shop/wall/middle/middle,/turf/city/wall/gap,/area)
"bq" = (/turf/shop/wall/middle/middle,/area)
"br" = (/turf/shop/wall/middle/middle,/turf/city/wall/gap/right,/area)
"bs" = (/turf/city/wall/bottom,/area)
"bt" = (/turf/shop_int/stairs/left,/area)
"bu" = (/turf/shop_int/stairs/middle,/area)
"bv" = (/turf/shop_int/stairs/right,/area)
"bw" = (/turf/city/wall/bottom,/turf/extra_roof/wood/right,/turf/extra_roof/wood/bottom/right,/area)
"bx" = (/turf/city/wall/bottom/right,/turf/extra_roof/wood/left,/area)
"by" = (/turf/shop/wall/bottom/left,/area)
"bz" = (/turf/shop/wall/bottom/middle,/area)
"bA" = (/turf/shop/wall/bottom/right,/area)
"bB" = (/turf/city/wall/bottom/left,/area)
"bC" = (/turf/city/wall/bottom/right,/area)
"bD" = (/turf/shop_int/floor,/obj/generic_shadow/white{alpha = 75; color = "black"; icon_state = "top"},/turf/inn/rail/left,/area)
"bE" = (/Building/Warper/Exterior,/turf/house/wooden_door{icon_state = "2"},/area)
"bF" = (/BuildingDetails{building_category = "Public"; building_cost = 50000; building_desc = "An apartment complex."; building_guild = ""; building_interior = 0; building_name = "G-Apartment"; building_settlement_only = 1},/turf/city/wall/bottom,/area)
"bG" = (/SmallPreview/Start,/turf,/area)
"bH" = (/turf/city/wall/blue{icon_state = "Left"},/turf/shop_int/stairs/bottom_left,/area)
"bI" = (/turf/shop_int/stairs/bottom,/area)
"bJ" = (/turf/city/wall/blue{density = 0; icon_state = "Right"},/turf/shop_int/stairs/bottom_right,/area)
"bK" = (/turf/village/building/wall/wall_1/middle/center,/turf/extra_roof/wood/top,/turf/house/wooden_window{density = 1; icon_state = "foilage1_bottom"},/turf/inn/rail/top_right,/area)
"bL" = (/turf/shop_int/floor,/obj/generic_shadow/white{alpha = 75; color = "black"; icon_state = "top"},/turf/inn/rail/right,/area)

(1,1,1) = {"
aaababababababababababababababacabababadae
aaabababababababababababababafagahabababaa
aaaiajajajajajajajajajajakalamanaoahababaa
aaapaqaqaqaqaqaqaqaqaqaqaqaqarasaoaoahabaa
aaapaqaqaqaqaqaqaqaqaqaqaqaratauaoaoaoavaa
aaapaqaqaqaqaqaqaqaqaqaqaratawaxayaoaoazaa
aaaAaBaCaCaCaCaCaCaCaCaDataEaFaGaHayaoazaa
aaabaIaJaJaJaJaJaJaJaJaKaLaMaGaGaGaNaOazaa
aaabaPbfaVaVaVaVaVaVaVaYaQaRaGaGaGaRaSaTaa
aaabaUbDaWaWaWaWaWaWaWaWaXbaaZaZaZbKbbabaa
aaabbcbdbebebebebebebebeaWaWaWaWaWbLbgabaa
aaabbhbibjbjbjbjbjbjbjbjbjbjbkblbmbnboabaa
aaababbcbpbqbrbsbFbsbpbqbrbsbtbubvbobwabaa
aaababbxbybzbAbBbsbCbybzbAbBbtbubvboababaa
aaababbxabababbBbEbCabababbBbtbubvboababaa
aabGababababababababababababbHbIbJabababaa
aaaaaaaaaaaaaaaaaaaaaaaaaaaaaaaaaaaaaaaaaa
"}
