"a" = (/turf/void,/area)
"b" = (/MapLimit,/turf,/area)
"c" = (/turf,/area)
"d" = (/obj/map/noDenseMarker,/turf/village/building/roof/roof_3/center/center_3,/area)
"e" = (/obj/map/noDenseMarker,/turf/village/building/roof/roof_3/left/left_3,/area)
"f" = (/obj/map/noDenseMarker,/turf/village/building/roof/roof_3/center/center_2,/area)
"g" = (/obj/map/noDenseMarker,/turf/village/building/roof/roof_3/right/right_3,/area)
"h" = (/turf/village/building/roof/roof_3/left/left_2,/area)
"i" = (/turf/village/building/roof/roof_3/center/center_2{layer = 5},/turf/village/horizontal_roof/top/left,/turf/village/building/roof/roof_3/center/center_3,/area)
"j" = (/turf/village/building/roof/roof_3/right/right_2{layer = 5},/turf/village/horizontal_roof/top{density = 1; layer = 7},/area)
"k" = (/turf/village/building/roof/roof_3/right/right_3{layer = 5},/obj/map/noDenseMarker,/turf/village/horizontal_roof/top{density = 1; layer = 7},/area)
"l" = (/obj/map/noDenseMarker,/turf/village/horizontal_roof/top{density = 1; layer = 7},/area)
"m" = (/obj/map/noDenseMarker,/turf/village/horizontal_roof/top/right,/area)
"n" = (/turf/village/building/roof/roof_3/center/center_2,/area)
"o" = (/turf/village/horizontal_roof/fill,/turf/village/building/roof/roof_3/right/right_3,/area)
"p" = (/turf/village/horizontal_roof/fill,/area)
"q" = (/obj/map/noDenseMarker,/turf/village/horizontal_roof/top/right/fill,/area)
"r" = (/obj/map/noDenseMarker,/turf/village/horizontal_roof/edge/left,/area)
"s" = (/turf/village/building/wall/wall_1/middle/center,/turf/extra_roof/wood,/turf/village/building/roof/roof_3/center/center_1,/turf/village/horizontal_roof/slope/peak,/Region{desc = "Osrona's merchant district, Caelfall has a high number of shops and large homes for those more well off than the majority of the population. Within the middle is a large park with a small body of water within it's center. The jail, as well as the City Watch's headquarters is also known to be found here."; name = "Caelfall"})
"t" = (/turf/village/building/roof/roof_3/right/right_2,/area)
"u" = (/obj/map/noDenseMarker,/turf/village/horizontal_roof/edge/left/middle,/area)
"v" = (/turf/village/building/wall/wall_1/middle/center,/turf/extra_roof/wood,/turf/village/building/roof/roof_3/left/left_1,/turf/village/horizontal_roof/slope/left,/Region{desc = "Osrona's merchant district, Caelfall has a high number of shops and large homes for those more well off than the majority of the population. Within the middle is a large park with a small body of water within it's center. The jail, as well as the City Watch's headquarters is also known to be found here."; name = "Caelfall"})
"w" = (/turf/village/building/wall/wall_1/middle/center,/turf/extra_roof/wood,/turf/village/horizontal_roof/slope/right/corner,/turf/village/horizontal_roof/slope/left/corner,/Region{desc = "Osrona's merchant district, Caelfall has a high number of shops and large homes for those more well off than the majority of the population. Within the middle is a large park with a small body of water within it's center. The jail, as well as the City Watch's headquarters is also known to be found here."; name = "Caelfall"})
"x" = (/turf/village/building/wall/wall_1/middle/center,/turf/extra_roof/wood,/turf/village/building/roof/roof_3/right/right_1,/turf/village/horizontal_roof/slope/right,/Region{desc = "Osrona's merchant district, Caelfall has a high number of shops and large homes for those more well off than the majority of the population. Within the middle is a large park with a small body of water within it's center. The jail, as well as the City Watch's headquarters is also known to be found here."; name = "Caelfall"})
"y" = (/turf/village/building/wall/wall_1/middle/center,/turf/extra_roof/wood,/turf/village/horizontal_roof/slope/left/corner,/Region{desc = "Osrona's merchant district, Caelfall has a high number of shops and large homes for those more well off than the majority of the population. Within the middle is a large park with a small body of water within it's center. The jail, as well as the City Watch's headquarters is also known to be found here."; name = "Caelfall"})
"z" = (/turf/village/building/wall/wall_1/middle/center,/turf/extra_roof/wood,/Region{desc = "Osrona's merchant district, Caelfall has a high number of shops and large homes for those more well off than the majority of the population. Within the middle is a large park with a small body of water within it's center. The jail, as well as the City Watch's headquarters is also known to be found here."; name = "Caelfall"})
"A" = (/turf/village/building/wall/wall_1/middle/center,/turf/extra_roof/wood,/turf/village/horizontal_roof/slope/right/corner,/Region{desc = "Osrona's merchant district, Caelfall has a high number of shops and large homes for those more well off than the majority of the population. Within the middle is a large park with a small body of water within it's center. The jail, as well as the City Watch's headquarters is also known to be found here."; name = "Caelfall"})
"B" = (/turf/village/building/wall/wall_1/middle/center,/turf/extra_roof/wood,/obj/generic_shadow/white{alpha = 75; color = "black"; icon_state = "full"; name = "house shadow"},/turf/village/horizontal_roof/bottom,/Region{desc = "Osrona's merchant district, Caelfall has a high number of shops and large homes for those more well off than the majority of the population. Within the middle is a large park with a small body of water within it's center. The jail, as well as the City Watch's headquarters is also known to be found here."; name = "Caelfall"})
"C" = (/turf/village/building/wall/wall_1/middle/center,/turf/extra_roof/wood,/BuildingDetails{building_category = "Public"; building_cost = 50000; building_desc = "A building with 2 rooms."; building_guild = ""; building_name = "G-House B"; building_settlement_only = 1},/turf/village/horizontal_roof/bottom,/Region{desc = "Osrona's merchant district, Caelfall has a high number of shops and large homes for those more well off than the majority of the population. Within the middle is a large park with a small body of water within it's center. The jail, as well as the City Watch's headquarters is also known to be found here."; name = "Caelfall"})
"D" = (/turf/village/building/wall/wall_1/middle/center,/turf/extra_roof/wood/right,/turf/village/horizontal_roof/bottom,/Region{desc = "Osrona's merchant district, Caelfall has a high number of shops and large homes for those more well off than the majority of the population. Within the middle is a large park with a small body of water within it's center. The jail, as well as the City Watch's headquarters is also known to be found here."; name = "Caelfall"})
"E" = (/obj/map/noDenseMarker,/turf/village/horizontal_roof/bottom/right,/area)
"F" = (/turf/village/building/wall/wall_1/middle/center,/turf/extra_roof/wood,/turf/village/horizontal_roof/slope/left/corner,/turf/house/wooden_window{density = 1; icon_state = "pointy_top"},/Region{desc = "Osrona's merchant district, Caelfall has a high number of shops and large homes for those more well off than the majority of the population. Within the middle is a large park with a small body of water within it's center. The jail, as well as the City Watch's headquarters is also known to be found here."; name = "Caelfall"})
"G" = (/turf/village/building/wall/wall_1/middle/center,/turf/extra_roof/wood,/turf/village/horizontal_roof/slope/right/corner,/turf/house/wooden_window{density = 1; icon_state = "pointy_top"},/Region{desc = "Osrona's merchant district, Caelfall has a high number of shops and large homes for those more well off than the majority of the population. Within the middle is a large park with a small body of water within it's center. The jail, as well as the City Watch's headquarters is also known to be found here."; name = "Caelfall"})
"H" = (/turf/village/building/wall/wall_1/middle/center,/turf/extra_roof/wood/right,/turf/village/building/roof/roof_3/right/right_1,/turf/village/horizontal_roof/slope/right,/Region{desc = "Osrona's merchant district, Caelfall has a high number of shops and large homes for those more well off than the majority of the population. Within the middle is a large park with a small body of water within it's center. The jail, as well as the City Watch's headquarters is also known to be found here."; name = "Caelfall"})
"I" = (/turf/village/building/wall/wall_1/middle/center,/obj/generic_shadow/white{alpha = 75; color = "black"; icon_state = "full"; name = "house shadow"},/turf/extra_roof/wood/top,/Region{desc = "Osrona's merchant district, Caelfall has a high number of shops and large homes for those more well off than the majority of the population. Within the middle is a large park with a small body of water within it's center. The jail, as well as the City Watch's headquarters is also known to be found here."; name = "Caelfall"})
"J" = (/turf/village/building/wall/wall_1/middle/center,/turf/extra_roof/wood/top,/Region{desc = "Osrona's merchant district, Caelfall has a high number of shops and large homes for those more well off than the majority of the population. Within the middle is a large park with a small body of water within it's center. The jail, as well as the City Watch's headquarters is also known to be found here."; name = "Caelfall"})
"K" = (/turf/village/building/wall/wall_1/middle/center,/turf/extra_roof/wood/bottom/right,/turf/extra_roof/wood/top/right,/Region{desc = "Osrona's merchant district, Caelfall has a high number of shops and large homes for those more well off than the majority of the population. Within the middle is a large park with a small body of water within it's center. The jail, as well as the City Watch's headquarters is also known to be found here."; name = "Caelfall"})
"L" = (/obj/map/noDenseMarker,/turf/village/horizontal_roof/corner/left,/area)
"M" = (/turf/village/building/wall/wall_1/middle/center,/turf/extra_roof/wood/bottom/left,/turf/extra_roof/wood/top/left,/turf/village/horizontal_roof/slope/left/corner,/Region{desc = "Osrona's merchant district, Caelfall has a high number of shops and large homes for those more well off than the majority of the population. Within the middle is a large park with a small body of water within it's center. The jail, as well as the City Watch's headquarters is also known to be found here."; name = "Caelfall"})
"N" = (/turf/house/wooden_window{density = 1; icon_state = "window_middle"},/turf/house/wooden_window{density = 1; icon_state = "foilage1_top"},/area)
"O" = (/turf/village/building/wall/wall_1/middle/center,/turf/extra_roof/wood/top,/area)
"P" = (/turf/village/building/wall/wall_1/middle/center,/turf/extra_roof/wood/bottom/right,/turf/extra_roof/wood/top/right,/turf/village/horizontal_roof/slope/right/corner,/Region{desc = "Osrona's merchant district, Caelfall has a high number of shops and large homes for those more well off than the majority of the population. Within the middle is a large park with a small body of water within it's center. The jail, as well as the City Watch's headquarters is also known to be found here."; name = "Caelfall"})
"Q" = (/obj/generic_shadow/white{alpha = 75; color = "black"; icon_state = "full"; name = "house shadow"},/turf/extra_roof/wall/middle/two,/Region{desc = "Osrona's merchant district, Caelfall has a high number of shops and large homes for those more well off than the majority of the population. Within the middle is a large park with a small body of water within it's center. The jail, as well as the City Watch's headquarters is also known to be found here."; name = "Caelfall"})
"R" = (/Building/Warper/Exterior,/turf/house/wooden_door{icon_state = "2"},/Region{desc = "Osrona's merchant district, Caelfall has a high number of shops and large homes for those more well off than the majority of the population. Within the middle is a large park with a small body of water within it's center. The jail, as well as the City Watch's headquarters is also known to be found here."; name = "Caelfall"})
"S" = (/turf/extra_roof/wall/middle/two,/turf/extra_roof/wood/right,/Region{desc = "Osrona's merchant district, Caelfall has a high number of shops and large homes for those more well off than the majority of the population. Within the middle is a large park with a small body of water within it's center. The jail, as well as the City Watch's headquarters is also known to be found here."; name = "Caelfall"})
"U" = (/turf/extra_roof/wall/middle/two,/turf/extra_roof/wood/left,/Region{desc = "Osrona's merchant district, Caelfall has a high number of shops and large homes for those more well off than the majority of the population. Within the middle is a large park with a small body of water within it's center. The jail, as well as the City Watch's headquarters is also known to be found here."; name = "Caelfall"})
"V" = (/turf/extra_roof/wall/middle/two,/turf/house/wooden_window{density = 1; icon_state = "foilage1_bottom"},/Region{desc = "Osrona's merchant district, Caelfall has a high number of shops and large homes for those more well off than the majority of the population. Within the middle is a large park with a small body of water within it's center. The jail, as well as the City Watch's headquarters is also known to be found here."; name = "Caelfall"})
"W" = (/turf/extra_roof/wall/middle/two,/Region{desc = "Osrona's merchant district, Caelfall has a high number of shops and large homes for those more well off than the majority of the population. Within the middle is a large park with a small body of water within it's center. The jail, as well as the City Watch's headquarters is also known to be found here."; name = "Caelfall"})
"X" = (/obj/generic_shadow/white{alpha = 50; color = "black"; icon_state = "tl_corner"; name = "house shadow corner"},/turf,/area)

(1,1,1) = {"
ccccdcccccccb
cccefgccccccc
ccehijkllllmc
cehhnopppppqc
rhhhstoppppqc
uhhvwxtopppqc
uhvyzAxtBCDEc
uvFzzzGHIJKcc
LMNOOONPQRScc
cUVWWWVSXcccc
aaaaaaaaaaaaa
"}
