"aa" = (/turf,/area)
"ab" = (/MapLimit,/turf,/area)
"ac" = (/turf/academy/wall/middle/right,/turf/village/horizontal_roof/bottom,/obj/generic_shadow/white{alpha = 25; color = "black"; icon_state = "full"},/turf/village/building/roof/roof_3/right/right_3,/area)
"ad" = (/turf/village/building/roof/roof_3/center/center_3,/area)
"ae" = (/Building/Warper/Exterior,/turf,/area)
"af" = (/turf/village/horizontal_roof/top/left{layer = 6},/area)
"ag" = (/turf/village/building/roof/roof_3/left/left_3,/turf/village/horizontal_roof/top{layer = 7},/area)
"ah" = (/turf/village/building/roof/roof_3/center/center_2,/area)
"ai" = (/turf/village/building/roof/roof_3/right/right_3,/turf/village/horizontal_roof/top{layer = 7},/area)
"aj" = (/turf/village/horizontal_roof/top/right,/area)
"ak" = (/turf/village/horizontal_roof/top/left/fill{layer = 6},/turf/village/building/roof/roof_3/left/left_3,/turf/village/horizontal_roof/top/left/fill{layer = 99},/area)
"al" = (/turf/village/horizontal_roof/fill,/area)
"am" = (/turf/village/building/roof/roof_3/right/right_3,/turf/village/horizontal_roof/top/right/fill{layer = 99},/area)
"an" = (/turf/village/horizontal_roof/edge/left{layer = 4},/area)
"ao" = (/turf/village/building/roof/roof_3/left/left_2,/turf/village/horizontal_roof/bottom/left{layer = 99},/area)
"ap" = (/turf/academy/wall/middle/left,/turf/village/horizontal_roof/bottom,/turf/village/building/roof/roof_3/left/left_3,/area)
"aq" = (/turf/village/horizontal_roof/fill,/obj/map/village/chimney/right{density = 1; layer = 7},/turf/village/building/roof/roof_3/right/right_3,/area)
"ar" = (/turf/village/building/roof/roof_3/right/right_2,/turf/village/horizontal_roof/bottom/right{layer = 99},/area)
"as" = (/turf/castle_int/column/roof,/turf/village/horizontal_roof/edge/right{density = 1; layer = 6},/area)
"at" = (/turf/village/horizontal_roof/edge/left/middle{layer = 4},/turf/village/horizontal_roof/top/left{layer = 6},/area)
"au" = (/turf/village/building/roof/roof_3/left/left_2,/turf/village/horizontal_roof/top{layer = 7},/area)
"av" = (/turf/village/building/roof/roof_3/right/right_2,/turf/village/horizontal_roof/top{layer = 7},/area)
"aw" = (/turf/castle_int/column/top,/turf/village/horizontal_roof/edge/right/middle{layer = 6},/turf/village/horizontal_roof/top/right{layer = 7},/area)
"ax" = (/turf/village/horizontal_roof/top/left/fill{layer = 6},/area)
"ay" = (/turf/village/horizontal_roof/fill,/turf/village/building/roof/roof_3/left/left_3,/area)
"az" = (/turf/village/horizontal_roof/fill,/turf/village/building/roof/roof_3/right/right_3,/area)
"aA" = (/turf/castle_int/column/middle,/turf/village/horizontal_roof/top/right/fill{layer = 6},/area)
"aB" = (/turf/village/horizontal_roof/edge/left/middle{layer = 4},/turf/village/horizontal_roof/bottom/left{layer = 6},/area)
"aC" = (/turf/village/building/roof/roof_3/left/left_2,/area)
"aD" = (/turf/village/building/wall/wall_1/middle/center,/turf/extra_roof/wood/top,/turf/village/building/roof/roof_3/center/center_1,/turf/village/horizontal_roof/slope/peak{density = 1},/area)
"aE" = (/turf/village/building/roof/roof_3/right/right_2,/area)
"aF" = (/turf/castle_int/column/middle{layer = 4},/turf/village/horizontal_roof/edge/right/middle{layer = 6},/turf/village/horizontal_roof/top{layer = 5},/turf/village/horizontal_roof/bottom/right{layer = 6},/area)
"aG" = (/turf/village/horizontal_roof/top,/turf/village/building/roof/roof_3/left/left_3,/turf/village/horizontal_roof/top{layer = 7},/area)
"aH" = (/turf/village/building/roof/roof_3/center/center_2,/turf/village/horizontal_roof/top{layer = 7},/turf/village/building/roof/roof_3/center/center_3{layer = 7},/area)
"aI" = (/turf/village/horizontal_roof/top,/turf/village/building/roof/roof_3/right/right_3,/turf/village/horizontal_roof/top{layer = 7},/area)
"aJ" = (/turf/village/horizontal_roof/top,/area)
"aK" = (/turf/village/horizontal_roof/top/right{layer = 7},/area)
"aL" = (/turf/village/horizontal_roof/edge/left/middle{layer = 4},/area)
"aM" = (/turf/village/building/wall/wall_1/middle/center,/turf/extra_roof/wood,/turf/village/building/roof/roof_3/left/left_1,/turf/village/horizontal_roof/slope/left{density = 1},/area)
"aN" = (/turf/village/building/wall/wall_1/middle/center,/turf/extra_roof/wood/top,/turf/village/horizontal_roof/slope/right/corner,/turf/village/horizontal_roof/slope/left/corner,/area)
"aO" = (/turf/village/building/wall/wall_1/middle/center,/turf/extra_roof/wood,/turf/village/building/roof/roof_3/right/right_1,/turf/village/horizontal_roof/slope/right,/area)
"aP" = (/turf/village/horizontal_roof/fill,/turf/village/horizontal_roof/edge/right/middle{layer = 9},/area)
"aQ" = (/turf/village/building/wall/wall_1/middle/center,/turf/village/building/roof/roof_3/center/center_1,/turf/house/wooden_window{icon_state = "pointy_top"; layer = 1.5},/turf/village/horizontal_roof/slope/peak{density = 1; layer = 2},/area)
"aR" = (/turf/extra_roof/wall/middle/two,/BuildingDetails{building_category = "Public"; building_cost = 25000; building_desc = "A house with 2 rooms!"; building_guild = ""; building_name = "G-Small House I"; building_settlement_only = 1; building_watchtower = 0},/turf/village/horizontal_roof/bottom,/area)
"aS" = (/turf/village/horizontal_roof/top/right/fill{layer = 6},/area)
"aT" = (/turf/village/building/wall/wall_1/middle/center,/turf/village/building/roof/roof_3/left/left_1,/turf/extra_roof/wood,/turf/village/horizontal_roof/slope/left{density = 1},/area)
"aU" = (/turf/village/building/wall/wall_1/middle/center,/turf/village/horizontal_roof/slope/left/corner,/turf/extra_roof/wood,/turf/house/wooden_window{icon_state = "pointy_top"},/area)
"aV" = (/turf/village/building/wall/wall_1/middle/center,/turf/extra_roof/wood,/area)
"aW" = (/turf/village/building/wall/wall_1/middle/center,/turf/extra_roof/wood,/turf/house/wooden_window{icon_state = "pointy_top"},/turf/village/horizontal_roof/slope/right/corner,/area)
"aX" = (/turf/village/building/wall/wall_1/middle/center,/turf/village/building/roof/roof_3/right/right_1,/turf/extra_roof/wood,/turf/village/horizontal_roof/slope/right,/area)
"aY" = (/turf/village/building/wall/wall_1/middle/center,/turf/extra_roof/wood/bottom/left,/turf/village/building/roof/roof_3/left/left_1,/turf/village/horizontal_roof/slope/left{density = 1},/area)
"aZ" = (/turf/village/building/wall/wall_1/middle/center,/turf/extra_roof/wood,/turf/house/wooden_window{icon_state = "window_bottom"},/turf/village/horizontal_roof/slope/right/corner,/turf/village/horizontal_roof/slope/left/corner,/area)
"ba" = (/turf/village/building/wall/wall_1/middle/center,/turf/extra_roof/wood/bottom/right,/turf/village/building/roof/roof_3/right/right_1,/turf/village/horizontal_roof/slope/right,/area)
"bb" = (/turf/extra_roof/wood/right,/turf/village/horizontal_roof/slope/right/corner{density = 1; layer = 7},/area)
"bc" = (/turf/village/building/wall/wall_1/middle/center,/turf/village/horizontal_roof/slope/left/corner{layer = 7},/turf/extra_roof/wood,/area)
"bd" = (/turf/house/wooden_window{icon_state = "window_middle"},/turf/house/wooden_window{icon_state = "foilage1_top"},/area)
"be" = (/turf/village/building/wall/wall_1/middle/center,/turf/village/horizontal_roof/slope/right/corner,/turf/extra_roof/wood,/area)
"bf" = (/turf/village/horizontal_roof/fill,/turf/extra_roof/wood/left,/turf/village/horizontal_roof/slope/left/corner{layer = 7},/area)
"bg" = (/turf/village/horizontal_roof/fill,/turf/house/wooden_window{icon_state = "foilage1_bottom"},/area)
"bh" = (/turf/village/horizontal_roof/fill,/turf/house/wooden_window{icon_state = "foilage2_bottom"},/area)
"bi" = (/turf/extra_roof/wood/right,/area)
"bj" = (/turf/village/building/wall/wall_1/middle/center,/turf/extra_roof/wood/top,/area)
"bk" = (/turf/village/building/wall/wall_1/middle/center,/turf/extra_roof/wood/bottom,/turf/extra_roof/wood/top,/turf/house/wooden_window{icon_state = "foilage2_bottom"},/area)
"bl" = (/turf/village/building/wall/wall_1/middle/center,/turf/extra_roof/wood/bottom,/turf/extra_roof/wood/top,/turf/house/wooden_window{icon_state = "foilage3_bottom"},/area)
"bm" = (/turf/extra_roof/wall/middle/two,/turf/village/horizontal_roof/bottom,/turf/extra_roof/wood/left,/area)
"bn" = (/turf/extra_roof/wall/middle/two,/turf/village/horizontal_roof/bottom,/area)
"bo" = (/turf/extra_roof/wall/middle/two,/turf/extra_roof/wood/right,/turf/village/horizontal_roof/bottom,/area)
"bp" = (/turf/village/horizontal_roof/bottom/right{layer = 6},/area)
"bq" = (/turf/village/horizontal_roof/slope/right/corner{density = 1; layer = 7},/area)
"br" = (/turf/extra_roof/wall/middle/two,/turf/extra_roof/wood/left,/turf/village/horizontal_roof/bottom,/area)
"bs" = (/Building/Warper/Exterior,/turf/house/wooden_door,/area)
"bt" = (/turf/extra_roof/wall/middle/three,/turf/village/horizontal_roof/slope/left/corner{layer = 7},/area)
"bu" = (/turf/extra_roof/wall/middle/three,/area)
"bv" = (/turf/extra_roof/wall/middle/three,/turf/extra_roof/wood/bottom/right,/area)
"bw" = (/SmallPreview/Start,/turf,/area)
"bx" = (/turf/extra_roof/wall/middle/three,/turf/extra_roof/wood/bottom/left,/area)

(1,1,1) = {"
aaaaaaadaaaaaaaaaaaaaaab
aaafagahaiajaaaaaaaaaaaa
aaakalahalamaaaaaaaaaaaa
anaoapahacarasaaaeaaaaaa
atauauahavavawaaaaaaaaaa
axalayahazalaAaaadaaaaaa
aBapaCaDaEacaFaGaHaIaJaK
aLaCaMaNaOaEaPayaQaqalaS
aLaTaUaVaWaXaPaYaZbaalaS
bbbcbdaVbdbebfbgbhbgalaS
bibjbkbjblbjbmbnbnbnbobp
bqbrbnaRbnbobtbubububvaa
bwbxbubsbubvaaaaaaaaaaaa
"}
