"aa" = (/MapLimit,/turf,/area)
"ab" = (/SmallPreview/End,/turf,/area)
"ac" = (/turf,/area)
"ad" = (/obj/map/noDenseMarker,/turf/village/building/roof/roof_3/center/center_3,/area)
"ae" = (/obj/map/noDenseMarker,/turf/village/building/roof/roof_3/left/left_3,/area)
"af" = (/obj/map/noDenseMarker,/turf/village/building/roof/roof_3/center/center_2,/area)
"ag" = (/obj/map/noDenseMarker,/turf/village/building/roof/roof_3/right/right_3,/area)
"ah" = (/turf/village/horizontal_roof/top/left,/area)
"ai" = (/turf/village/building/roof/roof_3/left/left_3{layer = 5},/obj/map/noDenseMarker,/turf/village/horizontal_roof/top{layer = 7},/area)
"aj" = (/turf/village/building/roof/roof_3/left/left_2{layer = 5},/turf/village/horizontal_roof/top{layer = 7},/area)
"ak" = (/turf/village/building/roof/roof_3/center/center_2{layer = 5},/turf/village/horizontal_roof/top/right{layer = 7},/turf/village/building/roof/roof_3/center/center_3{layer = 8},/area)
"al" = (/turf/village/building/roof/roof_3/right/right_2,/area)
"am" = (/turf/village/building/roof/roof_3/left/left_3{layer = 5},/obj/map/noDenseMarker,/turf/village/horizontal_roof/top/left/fill{layer = 9},/area)
"an" = (/turf/village/horizontal_roof/fill,/area)
"ao" = (/turf/village/horizontal_roof/fill,/turf/village/building/roof/roof_3/left/left_3,/area)
"ap" = (/turf/village/building/roof/roof_3/center/center_2,/area)
"aq" = (/obj/map/noDenseMarker,/turf/village/horizontal_roof/edge/left,/area)
"ar" = (/turf/village/building/roof/roof_3/left/left_2{layer = 5},/turf/village/horizontal_roof/bottom/left{layer = 9},/area)
"as" = (/turf/village/building/wall/wall_1/middle/center,/turf/extra_roof/wood/left,/turf/village/horizontal_roof/bottom,/turf/village/building/roof/roof_3/left/left_3,/Region{desc = "Osrona's merchant district, Caelfall has a high number of shops and large homes for those more well off than the majority of the population. Within the middle is a large park with a small body of water within it's center. The jail, as well as the City Watch's headquarters is also known to be found here."; name = "Caelfall"})
"at" = (/turf/village/building/roof/roof_3/left/left_2,/area)
"au" = (/turf/village/building/wall/wall_1/middle/center,/turf/extra_roof/wood,/turf/village/building/roof/roof_3/center/center_1,/turf/village/horizontal_roof/slope/peak,/Region{desc = "Osrona's merchant district, Caelfall has a high number of shops and large homes for those more well off than the majority of the population. Within the middle is a large park with a small body of water within it's center. The jail, as well as the City Watch's headquarters is also known to be found here."; name = "Caelfall"})
"av" = (/turf/castle_int/column/roof,/area)
"aw" = (/obj/map/noDenseMarker,/turf/village/horizontal_roof/edge/right,/area)
"ax" = (/obj/map/noDenseMarker,/turf/village/horizontal_roof/edge/left/middle,/area)
"ay" = (/turf/village/building/wall/wall_1/middle/center,/turf/extra_roof/wood,/turf/village/building/roof/roof_3/left/left_1,/turf/village/horizontal_roof/slope/left,/turf/village/building/roof/roof_3/center/center_3,/Region{desc = "Osrona's merchant district, Caelfall has a high number of shops and large homes for those more well off than the majority of the population. Within the middle is a large park with a small body of water within it's center. The jail, as well as the City Watch's headquarters is also known to be found here."; name = "Caelfall"})
"az" = (/turf/village/building/wall/wall_1/middle/center,/turf/extra_roof/wood,/turf/village/horizontal_roof/slope/right/corner,/turf/village/horizontal_roof/slope/left/corner,/Region{desc = "Osrona's merchant district, Caelfall has a high number of shops and large homes for those more well off than the majority of the population. Within the middle is a large park with a small body of water within it's center. The jail, as well as the City Watch's headquarters is also known to be found here."; name = "Caelfall"})
"aA" = (/turf/village/building/wall/wall_1/middle/center,/turf/extra_roof/wood,/turf/village/building/roof/roof_3/right/right_1,/turf/village/horizontal_roof/slope/right,/Region{desc = "Osrona's merchant district, Caelfall has a high number of shops and large homes for those more well off than the majority of the population. Within the middle is a large park with a small body of water within it's center. The jail, as well as the City Watch's headquarters is also known to be found here."; name = "Caelfall"})
"aB" = (/turf/castle_int/column/middle,/turf/village/building/roof/roof_3/right/right_3,/area)
"aC" = (/obj/map/noDenseMarker,/turf/village/horizontal_roof/edge/right/middle,/area)
"aD" = (/turf/village/building/wall/wall_1/middle/center,/turf/extra_roof/wood,/turf/village/building/roof/roof_3/right/right_3,/Region{desc = "Osrona's merchant district, Caelfall has a high number of shops and large homes for those more well off than the majority of the population. Within the middle is a large park with a small body of water within it's center. The jail, as well as the City Watch's headquarters is also known to be found here."; name = "Caelfall"})
"aE" = (/turf/village/building/wall/wall_1/middle/center,/turf/extra_roof/wood,/turf/village/horizontal_roof/slope/right/corner,/Region{desc = "Osrona's merchant district, Caelfall has a high number of shops and large homes for those more well off than the majority of the population. Within the middle is a large park with a small body of water within it's center. The jail, as well as the City Watch's headquarters is also known to be found here."; name = "Caelfall"})
"aF" = (/turf/village/building/wall/wall_1/middle/center,/turf/extra_roof/wood,/turf/house/wooden_window{density = 1; icon_state = "pointy_top"},/turf/village/building/roof/roof_3/right/right_1,/turf/village/horizontal_roof/slope/right,/area)
"aG" = (/turf/village/building/wall/wall_1/middle/center,/turf/extra_roof/wood/left,/turf/village/building/roof/roof_3/left/left_1,/turf/village/horizontal_roof/slope/left,/turf/village/horizontal_roof/edge/left,/Region{desc = "Osrona's merchant district, Caelfall has a high number of shops and large homes for those more well off than the majority of the population. Within the middle is a large park with a small body of water within it's center. The jail, as well as the City Watch's headquarters is also known to be found here."; name = "Caelfall"})
"aH" = (/turf/village/building/wall/wall_1/middle/center,/turf/extra_roof/wood,/obj/generic_shadow/white{alpha = 75; color = "black"; icon_state = "bl_corner"},/turf/village/horizontal_roof/edge/right{layer = 3},/Region{desc = "Osrona's merchant district, Caelfall has a high number of shops and large homes for those more well off than the majority of the population. Within the middle is a large park with a small body of water within it's center. The jail, as well as the City Watch's headquarters is also known to be found here."; name = "Caelfall"})
"aI" = (/turf/house/wooden_window{density = 1; icon_state = "window_middle"},/turf/house/wooden_window{density = 1; icon_state = "foilage1_top"},/turf/village/horizontal_roof/slope/right/corner,/area)
"aJ" = (/turf/village/building/wall/wall_1/middle/center,/turf/extra_roof/wood/right,/turf/village/building/roof/roof_3/right/right_1,/turf/village/horizontal_roof/slope/right,/Region{desc = "Osrona's merchant district, Caelfall has a high number of shops and large homes for those more well off than the majority of the population. Within the middle is a large park with a small body of water within it's center. The jail, as well as the City Watch's headquarters is also known to be found here."; name = "Caelfall"})
"aK" = (/obj/map/noDenseMarker,/turf/village/horizontal_roof/corner/left,/area)
"aL" = (/turf/village/building/wall/wall_1/middle/center,/turf/extra_roof/wood/bottom/left,/turf/extra_roof/wood/top/left,/turf/village/horizontal_roof/slope/left/corner,/turf/village/horizontal_roof/edge/left/middle,/Region{desc = "Osrona's merchant district, Caelfall has a high number of shops and large homes for those more well off than the majority of the population. Within the middle is a large park with a small body of water within it's center. The jail, as well as the City Watch's headquarters is also known to be found here."; name = "Caelfall"})
"aM" = (/turf/village/building/wall/wall_1/middle/center,/turf/extra_roof/wood/left,/turf/village/building/roof/roof_3/left/left_1,/turf/village/horizontal_roof/slope/left,/Region{desc = "Osrona's merchant district, Caelfall has a high number of shops and large homes for those more well off than the majority of the population. Within the middle is a large park with a small body of water within it's center. The jail, as well as the City Watch's headquarters is also known to be found here."; name = "Caelfall"})
"aN" = (/turf/village/building/wall/wall_1/middle/center,/turf/extra_roof/wood,/turf/village/horizontal_roof/slope/right/corner,/BuildingDetails{building_category = "Public"; building_cost = 50000; building_desc = "A building with 2 rooms."; building_guild = ""; building_name = "G-House A"; building_settlement_only = 1},/turf/village/horizontal_roof/slope/left/corner,/Region{desc = "Osrona's merchant district, Caelfall has a high number of shops and large homes for those more well off than the majority of the population. Within the middle is a large park with a small body of water within it's center. The jail, as well as the City Watch's headquarters is also known to be found here."; name = "Caelfall"})
"aO" = (/turf/village/building/wall/wall_1/middle/center,/turf/extra_roof/wood/top,/obj/generic_shadow/white{alpha = 75; color = "black"; icon_state = "full"; name = "house shadow"},/turf/village/horizontal_roof/edge/right/middle{layer = 3},/Region{desc = "Osrona's merchant district, Caelfall has a high number of shops and large homes for those more well off than the majority of the population. Within the middle is a large park with a small body of water within it's center. The jail, as well as the City Watch's headquarters is also known to be found here."; name = "Caelfall"})
"aP" = (/turf/village/building/wall/wall_1/middle/center,/turf/extra_roof/wood/top,/turf/house/wooden_window{density = 1; icon_state = "foilage1_bottom"},/area)
"aQ" = (/turf/village/building/wall/wall_1/middle/center,/turf/extra_roof/wood/bottom/right,/turf/extra_roof/wood/top/right,/turf/village/horizontal_roof/slope/right/corner,/Region{desc = "Osrona's merchant district, Caelfall has a high number of shops and large homes for those more well off than the majority of the population. Within the middle is a large park with a small body of water within it's center. The jail, as well as the City Watch's headquarters is also known to be found here."; name = "Caelfall"})
"aR" = (/obj/map/noDenseMarker,/turf/village/horizontal_roof/corner/right,/area)
"aS" = (/turf/extra_roof/wall/middle/two,/turf/extra_roof/wood/left,/turf/village/horizontal_roof/corner/left,/Region{desc = "Osrona's merchant district, Caelfall has a high number of shops and large homes for those more well off than the majority of the population. Within the middle is a large park with a small body of water within it's center. The jail, as well as the City Watch's headquarters is also known to be found here."; name = "Caelfall"})
"aT" = (/turf/village/building/wall/wall_1/middle/center,/turf/extra_roof/wood/bottom/left,/turf/extra_roof/wood/top/left,/turf/village/horizontal_roof/slope/left/corner,/Region{desc = "Osrona's merchant district, Caelfall has a high number of shops and large homes for those more well off than the majority of the population. Within the middle is a large park with a small body of water within it's center. The jail, as well as the City Watch's headquarters is also known to be found here."; name = "Caelfall"})
"aU" = (/turf/village/building/wall/wall_1/middle/center,/turf/extra_roof/wood/top,/Region{desc = "Osrona's merchant district, Caelfall has a high number of shops and large homes for those more well off than the majority of the population. Within the middle is a large park with a small body of water within it's center. The jail, as well as the City Watch's headquarters is also known to be found here."; name = "Caelfall"})
"aV" = (/turf/extra_roof/wall/middle/two,/obj/generic_shadow/white{alpha = 75; color = "black"; icon_state = "full"; name = "house shadow"},/turf/village/horizontal_roof/corner/right{layer = 3},/Region{desc = "Osrona's merchant district, Caelfall has a high number of shops and large homes for those more well off than the majority of the population. Within the middle is a large park with a small body of water within it's center. The jail, as well as the City Watch's headquarters is also known to be found here."; name = "Caelfall"})
"aW" = (/turf/extra_roof/wall/middle/two,/Region{desc = "Osrona's merchant district, Caelfall has a high number of shops and large homes for those more well off than the majority of the population. Within the middle is a large park with a small body of water within it's center. The jail, as well as the City Watch's headquarters is also known to be found here."; name = "Caelfall"})
"aX" = (/turf/extra_roof/wall/middle/two,/turf/extra_roof/wood/right,/Region{desc = "Osrona's merchant district, Caelfall has a high number of shops and large homes for those more well off than the majority of the population. Within the middle is a large park with a small body of water within it's center. The jail, as well as the City Watch's headquarters is also known to be found here."; name = "Caelfall"})
"aY" = (/SmallPreview/Start,/turf,/area)
"aZ" = (/turf/extra_roof/wall/middle/two,/turf/extra_roof/wood/left,/Region{desc = "Osrona's merchant district, Caelfall has a high number of shops and large homes for those more well off than the majority of the population. Within the middle is a large park with a small body of water within it's center. The jail, as well as the City Watch's headquarters is also known to be found here."; name = "Caelfall"})
"ba" = (/Building/Warper/Exterior,/turf/house/wooden_door{icon_state = "2"},/Region{desc = "Osrona's merchant district, Caelfall has a high number of shops and large homes for those more well off than the majority of the population. Within the middle is a large park with a small body of water within it's center. The jail, as well as the City Watch's headquarters is also known to be found here."; name = "Caelfall"})
"bb" = (/obj/generic_shadow/white{alpha = 50; color = "black"; icon_state = "tl_corner"; name = "house shadow corner"},/turf,/area)

(1,1,1) = {"
acacacacadacacacaa
acacacaeafagacacab
acahaiajakalagacac
acamanaoapalalagac
aqarasataualalavaw
axatatayazaAalaBaC
axatatapaDaEaFalaC
axaGataualaHaIaJaC
aKaLaMaNaJaOaPaQaR
acaSaTaUaQaVaWaXac
aYacaZbaaXbbacacac
"}
