"a" = (/turf/void,/area)
"b" = (/MapLimit,/turf/void,/area)
"c" = (/obj/map/viewBlock,/turf/void,/area)
"d" = (/turf/house/roof/corner/br,/area)
"e" = (/turf/house/roof/bottom,/area)
"f" = (/turf/house/roof/corner/bl,/area)
"g" = (/turf/house/roof/bottom_right,/area)
"h" = (/turf/village/building/wall/wall_1/top/top,/obj/generic_shadow/white{alpha = 50; color = "black"; icon_state = "full"; layer = 4},/turf/jianghu_house/shadow,/area)
"i" = (/turf/village/building/wall/wall_1/top/top,/turf/jianghu_house/shadow,/area)
"j" = (/turf/village/building/wall/wall_1/top/top,/turf/jianghu_house/shadow,/turf/house/wooden_window{icon_state = "window_top"},/area)
"k" = (/turf/house/roof/bottom_left,/area)
"l" = (/turf/house/roof/right,/area)
"m" = (/turf/village/building/wall/wall_1/top/right,/obj/generic_shadow/white{alpha = 50; color = "black"; icon_state = "full"; layer = 4},/turf/jianghu_house/shadow,/area)
"n" = (/obj/generic_shadow/white{alpha = 50; color = "black"; icon_state = "full"; layer = 4},/turf/village/building/wall/wall_1/middle/middle,/area)
"o" = (/turf/village/building/wall/wall_1/middle/middle,/area)
"p" = (/turf/house/wooden_window{icon_state = "window_middle"},/obj/map/cave_light,/turf/house/wooden_window{icon_state = "foilage1_top"},/area)
"q" = (/turf/village/building/wall/wall_1/top/left,/turf/jianghu_house/shadow,/area)
"r" = (/turf/house/roof/left,/area)
"s" = (/obj/generic_shadow/white{alpha = 50; color = "black"; icon_state = "full"; layer = 4},/turf/village/building/wall/wall_1/middle/right,/area)
"t" = (/obj/generic_shadow/white{alpha = 50; color = "black"; icon_state = "full"; layer = 4},/turf/extra_roof/wall/middle/two,/area)
"u" = (/turf/extra_roof/wall/middle/two,/area)
"v" = (/turf/extra_roof/wall/middle/two,/turf/house/wooden_window{icon_state = "foilage1_bottom"},/area)
"w" = (/turf/village/building/wall/wall_1/middle/left,/area)
"x" = (/turf/extra_roof/wall/middle/two,/obj/generic_shadow/white{alpha = 50; color = "black"; icon_state = "full"; layer = 4},/turf/extra_roof/wood/bottom/right,/area)
"y" = (/obj/generic_shadow/white{alpha = 50; color = "black"; icon_state = "tl_corner"; name = "house shadow corner"},/turf/inn/floor,/area)
"z" = (/turf/inn/floor,/area)
"A" = (/turf/extra_roof/wall/middle/two,/turf/extra_roof/wood/bottom/left,/area)
"B" = (/obj/generic_shadow/white{alpha = 50; color = "black"; icon_state = "full"; layer = 4},/turf/inn/floor,/area)
"C" = (/turf/house/roof/corner/tr,/area)
"D" = (/turf/house/roof/top,/area)
"E" = (/obj/map/DenseMarker,/turf/house/roof/top_right,/area)
"F" = (/Building/Warper/Dynamic{dynamic_id = "G-House A_room"},/turf/inn/floor,/area)
"G" = (/obj/map/DenseMarker,/turf/house/roof/top_left,/area)
"H" = (/turf/house/roof/corner/tl,/area)
"I" = (/obj/map/DenseMarker,/turf/house/roof/corner/tr,/area)
"J" = (/obj/map/DenseMarker,/obj/map/cave_light,/turf/house/roof/top,/area)
"K" = (/obj/map/DenseMarker,/turf/house/roof/corner/tl,/area)
"L" = (/obj/map/DenseMarker,/turf/house/roof/bottom,/area)
"M" = (/obj/map/DenseMarker,/turf/shop_int/stairs/middle,/area)
"N" = (/Building/Warper/Dynamic{dynamic_id = "G-House A_room"},/turf/shop_int/stairs/middle,/area)
"O" = (/turf/village/building/wall/wall_1/top/right,/turf/jianghu_house/shadow,/area)
"P" = (/turf/shop_int/stairs/middle,/area)
"Q" = (/turf/village/building/wall/wall_1/middle/right,/area)
"R" = (/turf/jianghu/brick_floor,/obj/generic_shadow/white{alpha = 50; color = "black"; icon_state = "full"; layer = 4},/obj/generic_shadow/white{alpha = 75; color = "black"; icon_state = "top"},/turf/village/road_brown/bottom,/area)
"S" = (/turf/jianghu/brick_floor,/obj/generic_shadow/white{alpha = 75; color = "black"; icon_state = "top"},/turf/village/road_brown/bottom,/area)
"T" = (/turf/extra_roof/wall/middle/two,/turf/extra_roof/wood/bottom/right,/area)
"U" = (/turf/jianghu/brick_floor,/obj/generic_shadow/white{alpha = 75; color = "black"; icon_state = "top"},/obj/generic_shadow/white{alpha = 50; color = "black"; icon_state = "tl_corner"; name = "house shadow corner"},/turf/village/road_brown/bottom,/area)
"V" = (/BuildingDetails{building_category = "Public"; building_cost = 50000; building_desc = "A building with 2 rooms."; building_guild = ""; building_interior = 1; building_name = "G-House A"; building_settlement_only = 1},/turf/inn/floor,/area)
"W" = (/Building/Warper/Interior,/turf/inn/floor,/area)

(1,1,1) = {"
aaaaaaaaaaaaaaaaaaaaaaaaaaaaaaaaaaaaaaaaaaaaaaaaaab
aaaaaaaaaaaaaaaaaaaaaaaaaaaaaaaaaaaaaaaaaaaaaaaaaaa
aaaaaaaaaaaaaaaaaaaaaaaaaaaaaaaaaaaaaaaaaaaaaaaaaaa
aaaaaaaaaaaaaaaaaaaaaaaaaaaaaaaaaaaaaaaaaaaaaaaaaaa
aaaaaaaaaaaaaaaaaaaaaaaaaaaaaaaaaaaaaaaaaaaaaaaaaaa
aaaaaaaaaaaaaaaaaaaaaaaaaaaaaaaaaaaaaaaaaaaaaaaaaaa
aaaaaaaaaaaaaaaaaaaaaaaaaaaaaaaaaaaaaaaaaaaaaaaaaaa
aaaaaaaaaaaaaaaaaaaaaaaaaaaaaaaaaaaaaaaaaaaaaaaaaaa
aaaaaaaaaaaaaaaaaaaaaaaaaaaaaaaaaaaaaaaaaaaaaaaaaaa
aaaaaaaaaaaaaaaaaaaaaaaaaaaaaaaaaaaaaaaaaaaaaaaaaaa
cccccccccccccccccccccccccaaaaaaaaaaaaaaaaaaaaaaaaaa
caaaaadeeeeeeeeeeefaaaaacaaaaaaaaaaaaaaaaaaaaaaaaaa
caaaadghijiiiiijiikfaaaacaaaaaaaaaaaaaaaaaaaaaaaaaa
caaaalmnopooooopooqraaaacaaaaaaaaaaaaaaaaaaaaaaaaaa
caaaalstuvuuuuuvuuwraaaacaaaaaaaaaaaaaaaaaaaaaaaaaa
caaaalxyzzzzzzzzzzAraaaacaaaaaaaaaaaaaaaaaaaaaaaaaa
caaaalBzzzzzzzzzzzzraaaacaaaaaaaaaaaaaaaaaaaaaaaaaa
caaaalBzzzzzzzzzzzzraaaacaaaaaaaaaaaaaaaaaaaaaaaaaa
caaaalBzzzzzzzzzzzzraaaacaaaaaaaaaaaaaaaaaaaaaaaaaa
caaaalBzzzzzzzzzzzzraaaacaaaaaaaaaaaaaaaaaaaaaaaaaa
caaaalBzzzzzzzzzzzzraaaacaaaaaaaaaaaaaaaaaaaaaaaaaa
caaaalBzzzzzzzzzzzzraaaacaaaaaaaaaaaaaaaaaaaaaaaaaa
caaaalBzzzzzzzzzzzzraaaacaaaaaaaaaaaaaaaaaaaaaaaaaa
caaaalBzzzzzzzzzzzzraaaacaaaaaaaaaaaaaaaaaaaaaaaaaa
caaaaCDDDDDEFGDDDDDHaaaacaaaaaaaaaaaaaaaaaaaaaaaaaa
caaaaaaaaaaIJKaaaaaaaaaacaaaaaaaaaaaaaaaaaaaaaaaaaa
caaaaaaaaaaaaaaaaaaaaaaacaaaaaaaaaaaaaaaaaaaaaaaaaa
caaaaaaaaaaaaaaaaaaaaaaacaaaaaaaaaaaaaaaaaaaaaaaaaa
caadeeeeefdLLLfdeeeeefaacaaaaaaaaaaaaaaaaaaaaaaaaaa
caalhijiikgMNMkghijiiraacaaaaaaaaaaaaaaaaaaaaaaaaaa
caalnopooqOPPPqOnopooraacaaaaaaaaaaaaaaaaaaaaaaaaaa
caaltuvuuwQPPPwQtuvuuraacaaaaaaaaaaaaaaaaaaaaaaaaaa
caalRSSSSATPPPATUSSSSraacaaaaaaaaaaaaaaaaaaaaaaaaaa
caalBzzzzzzzzzzzzzzzzraacaaaaaaaaaaaaaaaaaaaaaaaaaa
caalBzzzzzzzzzzzzzzzzraacaaaaaaaaaaaaaaaaaaaaaaaaaa
caalBzzzzzzzzzzzzzzzzraacaaaaaaaaaaaaaaaaaaaaaaaaaa
caalBzzzzzzzzzzzzzzzzraacaaaaaaaaaaaaaaaaaaaaaaaaaa
caalBzzzzzzzzzzzzzzzzraacaaaaaaaaaaaaaaaaaaaaaaaaaa
caalBzzzzzzzzzzzzzzzzraacaaaaaaaaaaaaaaaaaaaaaaaaaa
caalBzzzzzzzzzzzzzzzzraacaaaaaaaaaaaaaaaaaaaaaaaaaa
caalBzzzzzzzzzzzzzzzzraacaaaaaaaaaaaaaaaaaaaaaaaaaa
caalBzzzzzzzzzzzzzzzzraacaaaaaaaaaaaaaaaaaaaaaaaaaa
caalBzzzzzzzzzzzzzzzzraacaaaaaaaaaaaaaaaaaaaaaaaaaa
caalBzzzzzzzzzzzzzzzzraacaaaaaaaaaaaaaaaaaaaaaaaaaa
caalBzzzzzzzVzzzzzzzzraacaaaaaaaaaaaaaaaaaaaaaaaaaa
caalBzzzzzzzzzzzzzzzzraacaaaaaaaaaaaaaaaaaaaaaaaaaa
caaCDDDDDDDEWGDDDDDDDHaacaaaaaaaaaaaaaaaaaaaaaaaaaa
caaaaaaaaaaIJKaaaaaaaaaacaaaaaaaaaaaaaaaaaaaaaaaaaa
caaaaaaaaaaaaaaaaaaaaaaacaaaaaaaaaaaaaaaaaaaaaaaaaa
caaaaaaaaaaaaaaaaaaaaaaacaaaaaaaaaaaaaaaaaaaaaaaaaa
cccccccccccccccccccccccccaaaaaaaaaaaaaaaaaaaaaaaaaa
"}
