"aa" = (/turf/void,/area)
"ab" = (/turf,/area)
"ac" = (/obj/map/noDenseMarker,/turf/village/building/roof/roof_3/center/center_3,/area)
"ad" = (/SmallPreview/End,/turf,/area)
"ae" = (/MapLimit,/turf/void,/area)
"af" = (/obj/map/noDenseMarker,/turf/village/building/roof/roof_3/left/left_3,/area)
"ag" = (/obj/map/noDenseMarker,/turf/village/building/roof/roof_3/center/center_2,/area)
"ah" = (/obj/map/noDenseMarker,/turf/village/building/roof/roof_3/right/right_3,/area)
"ai" = (/obj/map/noDenseMarker,/turf/village/horizontal_roof/top/left,/area)
"aj" = (/obj/map/noDenseMarker,/turf/village/horizontal_roof/top{layer = 7},/area)
"ak" = (/obj/map/noDenseMarker,/turf/village/horizontal_roof/top,/area)
"al" = (/turf/village/building/roof/roof_3/left/left_3{layer = 5},/obj/map/noDenseMarker,/turf/village/horizontal_roof/top,/area)
"am" = (/turf/village/building/roof/roof_3/left/left_2{layer = 5},/turf/village/horizontal_roof/top,/area)
"an" = (/turf/village/building/roof/roof_3/center/center_2{layer = 5},/turf/village/horizontal_roof/top/right,/turf/village/building/roof/roof_3/center/center_3{layer = 9},/area)
"ao" = (/turf/village/building/roof/roof_3/right/right_2,/area)
"ap" = (/obj/map/noDenseMarker,/turf/village/horizontal_roof/top/left/fill,/area)
"aq" = (/turf/village/horizontal_roof/fill,/area)
"ar" = (/turf/village/horizontal_roof/fill,/turf/village/building/roof/roof_3/left/left_3,/area)
"as" = (/turf/village/building/roof/roof_3/center/center_2,/turf/village/horizontal_roof/top/right{layer = 7},/turf/village/building/roof/roof_3/center/center_3{layer = 8},/area)
"at" = (/turf/village/building/roof/roof_3/left/left_2,/area)
"au" = (/turf/village/building/wall/wall_1/middle/center,/turf/extra_roof/wood,/turf/village/building/roof/roof_3/center/center_1,/turf/village/horizontal_roof/slope/peak,/area)
"av" = (/obj/map/noDenseMarker,/turf/village/horizontal_roof/edge/right{layer = 3},/area)
"aw" = (/turf/village/building/wall/wall_1/middle/center,/turf/extra_roof/wood,/turf/village/building/roof/roof_3/left/left_1,/turf/village/horizontal_roof/slope/left,/area)
"ax" = (/turf/village/building/wall/wall_1/middle/center,/turf/extra_roof/wood,/turf/village/horizontal_roof/slope/right/corner,/turf/village/horizontal_roof/slope/left/corner,/area)
"ay" = (/turf/village/building/wall/wall_1/middle/center,/turf/extra_roof/wood,/turf/village/building/roof/roof_3/right/right_1,/turf/village/horizontal_roof/slope/right,/area)
"az" = (/obj/map/noDenseMarker,/turf/village/horizontal_roof/edge/right/middle{layer = 3},/area)
"aA" = (/turf/inn/rail/middle,/turf/inn/rail/left,/area)
"aB" = (/turf/inn/rail/middle,/area)
"aC" = (/turf/inn/rail/middle,/turf/village/horizontal_roof/bottom/left,/area)
"aD" = (/turf/village/building/wall/wall_1/middle/center,/turf/extra_roof/wood/left,/turf/village/horizontal_roof/bottom,/area)
"aE" = (/turf/village/building/wall/wall_1/middle/center,/turf/extra_roof/wood,/turf/village/horizontal_roof/bottom,/area)
"aF" = (/turf/village/building/wall/wall_1/middle/center,/turf/extra_roof/wood,/turf/village/horizontal_roof/bottom,/turf/village/horizontal_roof/edge/left,/area)
"aG" = (/turf/village/building/wall/wall_1/middle/center,/turf/village/building/roof/roof_3/left/left_1,/turf/village/horizontal_roof/slope/left,/area)
"aH" = (/turf/village/building/wall/wall_1/middle/center,/turf/extra_roof/wood,/turf/village/horizontal_roof/slope/left/corner,/area)
"aI" = (/turf/village/building/wall/wall_1/middle/center,/turf/extra_roof/wood,/area)
"aJ" = (/turf/village/building/wall/wall_1/middle/center,/turf/extra_roof/wood,/turf/village/horizontal_roof/slope/right/corner,/area)
"aK" = (/turf/shop_int/floor,/turf/inn/rail/left,/area)
"aL" = (/turf/inn/floor,/area)
"aM" = (/turf/extra_roof/wall/middle/two,/turf/extra_roof/wood/left,/area)
"aN" = (/turf/extra_roof/wall/middle/two,/area)
"aO" = (/turf/extra_roof/wall/middle/two,/turf/village/horizontal_roof/corner/left,/area)
"aP" = (/turf/village/building/wall/wall_1/middle/center,/turf/extra_roof/wood/left,/turf/village/horizontal_roof/slope/left/corner,/turf/house/wooden_window{density = 1; icon_state = "pointy_top"},/area)
"aQ" = (/turf/village/building/wall/wall_1/middle/center,/turf/extra_roof/wood,/turf/village/horizontal_roof/slope/right/corner,/turf/house/wooden_window{density = 1; icon_state = "pointy_top"},/area)
"aR" = (/turf/village/building/wall/wall_1/middle/center,/turf/extra_roof/wood/right,/turf/village/building/roof/roof_3/right/right_1,/turf/village/horizontal_roof/slope/right,/area)
"aS" = (/obj/generic_shadow/white{alpha = 75; color = "black"; icon_state = "top"},/turf/inn/floor,/area)
"aT" = (/turf/village/building/wall/wall_1/middle/center,/turf/extra_roof/wood/left,/turf/village/horizontal_roof/slope/left/corner,/area)
"aU" = (/turf/house/wooden_window{density = 1; icon_state = "window_middle"},/turf/house/wooden_window{density = 1; icon_state = "foilage1_top"},/area)
"aV" = (/turf/village/building/wall/wall_1/middle/center,/turf/extra_roof/wood/right,/turf/village/horizontal_roof/slope/right/corner,/area)
"aW" = (/obj/map/noDenseMarker,/turf/village/horizontal_roof/corner/right{layer = 3},/area)
"aX" = (/turf/village/building/wall/wall_1/middle/center,/turf/extra_roof/wood/bottom/left,/turf/extra_roof/wood/top/left,/area)
"aY" = (/turf/village/building/wall/wall_1/middle/center,/turf/extra_roof/wood/top,/turf/house/wooden_window{density = 1; icon_state = "foilage1_bottom"},/turf/inn/rail/right{layer = 3.2},/area)
"aZ" = (/turf/village/building/wall/wall_1/middle/center,/turf/extra_roof/wood/top,/area)
"ba" = (/turf/village/building/wall/wall_1/middle/center,/BuildingDetails{building_category = "Public"; building_cost = 75000; building_desc = "A building with 2 rooms."; building_guild = ""; building_name = "Public House_A"; building_rent = 100; building_rent_upfront = 3000},/turf/extra_roof/wood/top,/area)
"bb" = (/turf/village/building/wall/wall_1/middle/center,/turf/extra_roof/wood/top,/turf/house/wooden_window{density = 1; icon_state = "foilage1_bottom"},/area)
"bc" = (/turf/village/building/wall/wall_1/middle/center,/turf/extra_roof/wood/bottom/right,/turf/extra_roof/wood/top/right,/area)
"bd" = (/turf/inn/floor,/obj/generic_shadow/white{alpha = 75; color = "black"; icon_state = "top"},/turf/inn/rail/right{layer = 3.2},/area)
"be" = (/obj/generic_shadow/white{alpha = 75; color = "black"; icon_state = "bl_corner"; layer = 1},/turf/extra_roof/wall/middle/two,/area)
"bf" = (/turf/extra_roof/wall/middle/two,/turf/extra_roof/wood/right,/area)
"bg" = (/turf/inn/floor,/turf/inn/rail/middle,/area)
"bh" = (/turf/shop_int/floor,/turf/shop_int/stairs/top_left,/area)
"bi" = (/turf/shop_int/floor,/turf/shop_int/stairs/top,/area)
"bj" = (/turf/shop_int/floor,/turf/shop_int/stairs/top_right,/area)
"bk" = (/obj/generic_shadow/white{alpha = 75; color = "black"; icon_state = "full"; name = "house shadow"},/turf/city/wall/bottom,/area)
"bl" = (/obj/generic_shadow/white{alpha = 75; color = "black"; icon_state = "bl_corner"; layer = 1},/turf/city/wall/bottom,/area)
"bm" = (/Building/Warper/Exterior,/turf/house/wooden_door{icon_state = "2"},/area)
"bn" = (/turf/city/wall/bottom,/area)
"bo" = (/turf/city/wall/bottom,/turf/extra_roof/wood/right,/area)
"bp" = (/turf/city/wall/bottom,/turf/extra_roof/wood/left,/turf/house/wooden_window{icon_state = "foilage1_bottom"; layer = 7},/area)
"bq" = (/turf/city/wall/bottom,/turf/city/wall/gap,/obj/generic_shadow/white{alpha = 100; color = "black"; icon_state = "full"; layer = 4},/turf/house/wooden_window{icon_state = "foilage1_bottom"; layer = 7},/area)
"br" = (/turf/city/wall/bottom,/turf/city/wall/gap/right,/obj/generic_shadow/white{alpha = 100; color = "black"; icon_state = "full"; layer = 4},/turf/house/wooden_window{icon_state = "foilage1_bottom"; layer = 7},/area)
"bs" = (/turf/city/wall/bottom,/turf/house/wooden_window{icon_state = "foilage1_bottom"; layer = 7},/area)
"bt" = (/turf/shop_int/stairs/left,/area)
"bu" = (/turf/shop_int/stairs/bottom,/area)
"bv" = (/turf/shop_int/stairs/right,/area)
"bw" = (/turf/forest/grass/grass_2,/obj/generic_shadow/white{alpha = 75; color = "black"; icon_state = "full"; name = "house shadow"},/obj/map/forest/shrubbery/shrub3,/obj/map/forest/flower/grass/flower_19,/turf/village/road_brown/right,/area)
"bx" = (/turf/city/wall/bottom,/SmallPreview/Start,/turf/extra_roof/wood/bottom/left,/area)
"by" = (/obj/generic_shadow/white{alpha = 75; color = "black"; icon_state = "full"; name = "house shadow"},/obj/generic_shadow/white{alpha = 75; color = "black"; icon_state = "top"},/turf,/area)
"bz" = (/turf/forest/grass/grass_2,/obj/map/forest/shrubbery/shrub3,/obj/map/forest/flower/grass/flower_11,/obj/generic_shadow/white{alpha = 75; color = "black"; icon_state = "full"; name = "house shadow"},/turf/village/road_brown/bottom_right,/area)
"bA" = (/turf/shop_int/stairs/bottom,/turf/shop_int/stairs/bottom_left,/area)
"bB" = (/turf/village/dirt/middle,/turf/shop_int/stairs/bottom_right,/area)
"bC" = (/obj/generic_shadow/white{alpha = 50; color = "black"; icon_state = "tl_corner"; name = "house shadow corner"},/turf,/area)

(1,1,1) = {"
aaabababababababababababacabababadae
aaababababababababababafagahabababaa
aaababababaiajajajakalamanaoahababaa
aaababababapaqaqaqaqaqarasaoaoahabaa
aaababababapaqaqaqaqaratauaoaoaoavaa
aaababababapaqaqaqaratawaxayaoaoazaa
aaaAaBaBaBaCaDaEaFataGaHaIaJayaoazaa
aaaKaLaLaLaLaMaNaOaGaPaIaIaIaQaRazaa
aaaKaLaLaLaLaSaSaSaTaUaIaIaIaUaVaWaa
aaaKaLaLaLaLaLaLaLaXaYaZaZbabbbcabaa
aaaKaLaLaLaLaLaLaLaSbdbeaNaNaNbfabaa
aabgbgbgbgbgbgbgbhbibjbkblbmbnboabaa
aabpbqbrbsbqbrbsbtbubvbwabababababaa
aabxbybybnbybybnbtbubvbzabababababaa
aaabababababababbAbubBbCabababababaa
aaaaaaaaaaaaaaaaaaaaaaaaaaaaaaaaaaaa
"}
